,num_female,num_male,num_other,num_unknown,num_total,ratio_female,male_female_difference
242118,1,5,0,1,7,0.14285714285714285,0.5714285714285714
60569,1,5,0,1,7,0.14285714285714285,0.5714285714285714
96954,1,5,0,1,7,0.14285714285714285,0.5714285714285714
177040,3,11,0,0,14,0.21428571428571427,0.5714285714285714
30985,4,16,0,1,21,0.19047619047619047,0.5714285714285714
119725,0,20,0,15,35,0.0,0.5714285714285714
57234,3,11,0,0,14,0.21428571428571427,0.5714285714285714
82808,0,4,0,3,7,0.0,0.5714285714285714
160434,1,5,0,1,7,0.14285714285714285,0.5714285714285714
172613,1,5,0,1,7,0.14285714285714285,0.5714285714285714
45315,4,16,0,1,21,0.19047619047619047,0.5714285714285714
72190,1,5,0,1,7,0.14285714285714285,0.5714285714285714
195469,3,11,0,0,14,0.21428571428571427,0.5714285714285714
82699,1,5,0,1,7,0.14285714285714285,0.5714285714285714
154781,1,5,0,1,7,0.14285714285714285,0.5714285714285714
204822,1,5,0,1,7,0.14285714285714285,0.5714285714285714
207246,3,15,0,3,21,0.14285714285714285,0.5714285714285714
69252,1,5,0,1,7,0.14285714285714285,0.5714285714285714
246766,1,5,0,1,7,0.14285714285714285,0.5714285714285714
25216,1,5,0,1,7,0.14285714285714285,0.5714285714285714
5728,1,5,0,1,7,0.14285714285714285,0.5714285714285714
93085,1,5,0,1,7,0.14285714285714285,0.5714285714285714
147803,0,4,0,3,7,0.0,0.5714285714285714
82942,1,5,0,1,7,0.14285714285714285,0.5714285714285714
118434,0,4,0,3,7,0.0,0.5714285714285714
18095,1,5,0,1,7,0.14285714285714285,0.5714285714285714
272202,1,5,0,1,7,0.14285714285714285,0.5714285714285714
179791,2,21,0,10,33,0.06060606060606061,0.5757575757575758
101606,11,44,0,2,57,0.19298245614035087,0.5789473684210527
23511,4,15,0,0,19,0.21052631578947367,0.5789473684210527
20201,4,15,0,0,19,0.21052631578947367,0.5789473684210527
272225,4,15,0,0,19,0.21052631578947367,0.5789473684210527
79089,2,9,0,1,12,0.16666666666666666,0.5833333333333334
174848,2,9,0,1,12,0.16666666666666666,0.5833333333333334
28865,2,9,0,1,12,0.16666666666666666,0.5833333333333334
164728,5,19,0,0,24,0.20833333333333334,0.5833333333333334
231351,5,21,0,1,27,0.18518518518518517,0.5925925925925926
225986,4,20,0,3,27,0.14814814814814814,0.5925925925925926
270838,5,21,0,1,27,0.18518518518518517,0.5925925925925926
96440,6,25,0,1,32,0.1875,0.59375
70594,9,43,0,5,57,0.15789473684210525,0.5964912280701754
229899,1,4,0,0,5,0.2,0.6
122671,1,4,0,0,5,0.2,0.6
250219,1,4,0,0,5,0.2,0.6
189789,0,3,0,2,5,0.0,0.6
21708,1,4,0,0,5,0.2,0.6
80075,1,4,0,0,5,0.2,0.6
8089,1,4,0,0,5,0.2,0.6
146641,1,4,0,0,5,0.2,0.6
20032,1,4,0,0,5,0.2,0.6
33270,1,4,0,0,5,0.2,0.6
114452,1,4,0,0,5,0.2,0.6
79754,1,4,0,0,5,0.2,0.6
100984,1,4,0,0,5,0.2,0.6
228652,1,4,0,0,5,0.2,0.6
79366,1,4,0,0,5,0.2,0.6
145887,1,4,0,0,5,0.2,0.6
144632,1,4,0,0,5,0.2,0.6
123115,1,4,0,0,5,0.2,0.6
240111,1,4,0,0,5,0.2,0.6
78719,2,8,0,0,10,0.2,0.6
188878,1,4,0,0,5,0.2,0.6
145218,1,4,0,0,5,0.2,0.6
78229,1,4,0,0,5,0.2,0.6
78007,1,4,0,0,5,0.2,0.6
239609,1,4,0,0,5,0.2,0.6
229448,1,4,0,0,5,0.2,0.6
137968,1,4,0,0,5,0.2,0.6
34932,1,7,0,2,10,0.1,0.6
271284,1,4,0,0,5,0.2,0.6
203973,1,4,0,0,5,0.2,0.6
79055,1,4,0,0,5,0.2,0.6
253403,0,3,0,2,5,0.0,0.6
270211,1,4,0,0,5,0.2,0.6
270829,1,4,0,0,5,0.2,0.6
68767,1,4,0,0,5,0.2,0.6
143009,1,4,0,0,5,0.2,0.6
72742,1,4,0,0,5,0.2,0.6
236618,1,4,0,0,5,0.2,0.6
257777,1,4,0,0,5,0.2,0.6
68984,5,20,0,0,25,0.2,0.6
200993,0,3,0,2,5,0.0,0.6
236235,1,4,0,0,5,0.2,0.6
71831,1,4,0,0,5,0.2,0.6
196050,1,4,0,0,5,0.2,0.6
196052,3,12,0,0,15,0.2,0.6
267680,1,4,0,0,5,0.2,0.6
269308,1,4,0,0,5,0.2,0.6
119326,1,4,0,0,5,0.2,0.6
117092,1,4,0,0,5,0.2,0.6
117396,1,4,0,0,5,0.2,0.6
199095,1,4,0,0,5,0.2,0.6
269114,1,4,0,0,5,0.2,0.6
196317,1,4,0,0,5,0.2,0.6
141210,1,4,0,0,5,0.2,0.6
118659,1,4,0,0,5,0.2,0.6
38661,1,4,0,0,5,0.2,0.6
71181,1,4,0,0,5,0.2,0.6
5209,1,4,0,0,5,0.2,0.6
165516,1,4,0,0,5,0.2,0.6
38081,1,4,0,0,5,0.2,0.6
252233,1,4,0,0,5,0.2,0.6
118135,2,8,0,0,10,0.2,0.6
70918,1,4,0,0,5,0.2,0.6
118320,2,8,0,0,10,0.2,0.6
196113,1,4,0,0,5,0.2,0.6
194273,1,4,0,0,5,0.2,0.6
201593,1,4,0,0,5,0.2,0.6
236955,1,4,0,0,5,0.2,0.6
190480,1,4,0,0,5,0.2,0.6
203017,2,8,0,0,10,0.2,0.6
35925,1,4,0,0,5,0.2,0.6
102189,1,4,0,0,5,0.2,0.6
238607,1,4,0,0,5,0.2,0.6
116249,1,4,0,0,5,0.2,0.6
41667,1,4,0,0,5,0.2,0.6
230878,1,4,0,0,5,0.2,0.6
3329,1,4,0,0,5,0.2,0.6
36103,1,4,0,0,5,0.2,0.6
36141,1,4,0,0,5,0.2,0.6
16943,0,3,0,2,5,0.0,0.6
120181,1,4,0,0,5,0.2,0.6
159455,1,4,0,0,5,0.2,0.6
267334,1,4,0,0,5,0.2,0.6
202147,1,4,0,0,5,0.2,0.6
68000,1,4,0,0,5,0.2,0.6
232107,1,4,0,0,5,0.2,0.6
74571,1,4,0,0,5,0.2,0.6
232067,2,8,0,0,10,0.2,0.6
193740,1,4,0,0,5,0.2,0.6
193156,1,4,0,0,5,0.2,0.6
75777,1,4,0,0,5,0.2,0.6
138425,1,4,0,0,5,0.2,0.6
68383,2,8,0,0,10,0.2,0.6
75787,1,4,0,0,5,0.2,0.6
192696,1,4,0,0,5,0.2,0.6
270069,2,8,0,0,10,0.2,0.6
201829,1,4,0,0,5,0.2,0.6
270121,1,4,0,0,5,0.2,0.6
76001,1,4,0,0,5,0.2,0.6
139706,1,4,0,0,5,0.2,0.6
251362,1,4,0,0,5,0.2,0.6
61354,1,4,0,0,5,0.2,0.6
64396,2,8,0,0,10,0.2,0.6
250494,1,4,0,0,5,0.2,0.6
260473,1,4,0,0,5,0.2,0.6
215753,1,4,0,0,5,0.2,0.6
254486,1,4,0,0,5,0.2,0.6
127036,0,3,0,2,5,0.0,0.6
275520,2,8,0,0,10,0.2,0.6
56623,1,4,0,0,5,0.2,0.6
95353,0,3,0,2,5,0.0,0.6
246388,1,4,0,0,5,0.2,0.6
126824,1,4,0,0,5,0.2,0.6
222788,1,4,0,0,5,0.2,0.6
246246,1,4,0,0,5,0.2,0.6
277922,1,4,0,0,5,0.2,0.6
219530,1,4,0,0,5,0.2,0.6
154021,1,4,0,0,5,0.2,0.6
56905,1,4,0,0,5,0.2,0.6
133738,2,8,0,0,10,0.2,0.6
186533,1,4,0,0,5,0.2,0.6
86368,1,4,0,0,5,0.2,0.6
95781,1,4,0,0,5,0.2,0.6
223714,1,4,0,0,5,0.2,0.6
86419,1,4,0,0,5,0.2,0.6
223608,1,4,0,0,5,0.2,0.6
174322,1,4,0,0,5,0.2,0.6
108763,1,4,0,0,5,0.2,0.6
49392,2,8,0,0,10,0.2,0.6
177195,1,4,0,0,5,0.2,0.6
88299,1,4,0,0,5,0.2,0.6
28257,1,4,0,0,5,0.2,0.6
162840,1,4,0,0,5,0.2,0.6
250851,1,4,0,0,5,0.2,0.6
108700,1,4,0,0,5,0.2,0.6
161870,1,4,0,0,5,0.2,0.6
158103,2,8,0,0,10,0.2,0.6
254754,1,4,0,0,5,0.2,0.6
217496,1,4,0,0,5,0.2,0.6
217673,1,4,0,0,5,0.2,0.6
102154,1,4,0,0,5,0.2,0.6
24733,1,4,0,0,5,0.2,0.6
54624,1,4,0,0,5,0.2,0.6
94213,1,4,0,0,5,0.2,0.6
55097,1,4,0,0,5,0.2,0.6
169727,1,4,0,0,5,0.2,0.6
169465,1,4,0,0,5,0.2,0.6
157594,0,3,0,2,5,0.0,0.6
276563,1,4,0,0,5,0.2,0.6
255289,1,4,0,0,5,0.2,0.6
162014,1,4,0,0,5,0.2,0.6
53408,1,4,0,0,5,0.2,0.6
24186,2,8,0,0,10,0.2,0.6
178587,1,4,0,0,5,0.2,0.6
217270,1,4,0,0,5,0.2,0.6
102130,1,4,0,0,5,0.2,0.6
127389,1,4,0,0,5,0.2,0.6
216260,1,4,0,0,5,0.2,0.6
102019,1,4,0,0,5,0.2,0.6
92278,1,4,0,0,5,0.2,0.6
51826,0,3,0,2,5,0.0,0.6
155343,1,4,0,0,5,0.2,0.6
220945,1,4,0,0,5,0.2,0.6
216557,1,4,0,0,5,0.2,0.6
171999,1,4,0,0,5,0.2,0.6
55487,1,7,0,2,10,0.1,0.6
248131,1,4,0,0,5,0.2,0.6
216955,1,4,0,0,5,0.2,0.6
221050,1,4,0,0,5,0.2,0.6
171045,2,8,0,0,10,0.2,0.6
92693,1,4,0,0,5,0.2,0.6
152136,1,4,0,0,5,0.2,0.6
161385,1,4,0,0,5,0.2,0.6
109562,0,3,0,2,5,0.0,0.6
185497,1,4,0,0,5,0.2,0.6
265194,1,4,0,0,5,0.2,0.6
185071,1,4,0,0,5,0.2,0.6
45564,1,4,0,0,5,0.2,0.6
19659,1,4,0,0,5,0.2,0.6
184990,0,3,0,2,5,0.0,0.6
80826,2,8,0,0,10,0.2,0.6
46154,1,4,0,0,5,0.2,0.6
184918,1,4,0,0,5,0.2,0.6
184684,1,4,0,0,5,0.2,0.6
148157,1,4,0,0,5,0.2,0.6
272890,1,4,0,0,5,0.2,0.6
1435,4,16,0,0,20,0.2,0.6
1412,1,4,0,0,5,0.2,0.6
242083,18,78,0,4,100,0.18,0.6
272233,1,4,0,0,5,0.2,0.6
113602,1,4,0,0,5,0.2,0.6
45078,1,4,0,0,5,0.2,0.6
113966,1,4,0,0,5,0.2,0.6
205963,1,4,0,0,5,0.2,0.6
64241,2,8,0,0,10,0.2,0.6
256874,1,4,0,0,5,0.2,0.6
137397,1,4,0,0,5,0.2,0.6
8487,1,4,0,0,5,0.2,0.6
19972,1,4,0,0,5,0.2,0.6
113657,2,8,0,0,10,0.2,0.6
2041,1,4,0,0,5,0.2,0.6
101091,1,4,0,0,5,0.2,0.6
206877,1,4,0,0,5,0.2,0.6
265383,1,4,0,0,5,0.2,0.6
265313,9,42,0,4,55,0.16363636363636364,0.6
241513,1,4,0,0,5,0.2,0.6
276681,1,4,0,0,5,0.2,0.6
225989,2,8,0,0,10,0.2,0.6
152036,1,4,0,0,5,0.2,0.6
38281,7,28,0,0,35,0.2,0.6
242458,1,4,0,0,5,0.2,0.6
124769,1,4,0,0,5,0.2,0.6
48995,1,4,0,0,5,0.2,0.6
262666,1,4,0,0,5,0.2,0.6
29056,1,4,0,0,5,0.2,0.6
29101,1,4,0,0,5,0.2,0.6
179532,1,4,0,0,5,0.2,0.6
135141,1,4,0,0,5,0.2,0.6
262974,1,7,0,2,10,0.1,0.6
29424,1,4,0,0,5,0.2,0.6
151370,1,4,0,0,5,0.2,0.6
110112,2,8,0,0,10,0.2,0.6
47975,1,4,0,0,5,0.2,0.6
167494,2,8,0,0,10,0.2,0.6
179885,1,4,0,0,5,0.2,0.6
81578,1,4,0,0,5,0.2,0.6
111536,1,4,0,0,5,0.2,0.6
112507,1,4,0,0,5,0.2,0.6
30445,2,8,0,0,10,0.2,0.6
46461,1,4,0,0,5,0.2,0.6
111938,1,4,0,0,5,0.2,0.6
209833,1,4,0,0,5,0.2,0.6
182931,1,4,0,0,5,0.2,0.6
123732,1,4,0,0,5,0.2,0.6
82720,1,4,0,0,5,0.2,0.6
149259,1,4,0,0,5,0.2,0.6
183740,1,4,0,0,5,0.2,0.6
46690,1,4,0,0,5,0.2,0.6
1129,1,4,0,0,5,0.2,0.6
242637,1,4,0,0,5,0.2,0.6
81672,1,4,0,0,5,0.2,0.6
201768,3,14,0,1,18,0.16666666666666666,0.6111111111111112
115435,12,50,0,0,62,0.1935483870967742,0.6129032258064516
96744,5,21,0,0,26,0.19230769230769232,0.6153846153846154
175254,2,10,0,1,13,0.15384615384615385,0.6153846153846154
249953,2,10,0,1,13,0.15384615384615385,0.6153846153846154
107326,5,21,0,0,26,0.19230769230769232,0.6153846153846154
268030,4,20,0,2,26,0.15384615384615385,0.6153846153846154
128033,2,10,0,1,13,0.15384615384615385,0.6153846153846154
52175,2,10,0,1,13,0.15384615384615385,0.6153846153846154
213316,2,10,0,1,13,0.15384615384615385,0.6153846153846154
185176,6,27,0,1,34,0.17647058823529413,0.6176470588235294
126492,18,80,0,2,100,0.18,0.62
244171,5,23,0,1,29,0.1724137931034483,0.6206896551724138
75819,8,36,0,1,45,0.17777777777777778,0.6222222222222222
153091,1,6,0,1,8,0.125,0.625
95010,3,13,0,0,16,0.1875,0.625
81609,1,6,0,1,8,0.125,0.625
164926,3,13,0,0,16,0.1875,0.625
81855,1,6,0,1,8,0.125,0.625
37235,1,6,0,1,8,0.125,0.625
1211,0,5,0,3,8,0.0,0.625
106131,1,6,0,1,8,0.125,0.625
87949,3,13,0,0,16,0.1875,0.625
248098,3,13,0,0,16,0.1875,0.625
191883,1,6,0,1,8,0.125,0.625
76530,4,19,0,1,24,0.16666666666666666,0.625
185154,1,6,0,1,8,0.125,0.625
166017,1,6,0,1,8,0.125,0.625
208451,1,6,0,1,8,0.125,0.625
103315,1,6,0,1,8,0.125,0.625
115224,1,6,0,1,8,0.125,0.625
127648,0,5,0,3,8,0.0,0.625
94730,1,6,0,1,8,0.125,0.625
92215,1,6,0,1,8,0.125,0.625
17894,0,5,0,3,8,0.0,0.625
219208,0,5,0,3,8,0.0,0.625
152645,3,15,0,1,19,0.15789473684210525,0.631578947368421
111944,5,24,0,1,30,0.16666666666666666,0.6333333333333333
246759,5,24,0,1,30,0.16666666666666666,0.6333333333333333
104051,2,9,0,0,11,0.18181818181818182,0.6363636363636364
178797,1,8,0,2,11,0.09090909090909091,0.6363636363636364
54884,2,9,0,0,11,0.18181818181818182,0.6363636363636364
26553,2,9,0,0,11,0.18181818181818182,0.6363636363636364
245157,2,9,0,0,11,0.18181818181818182,0.6363636363636364
93358,2,9,0,0,11,0.18181818181818182,0.6363636363636364
254053,2,9,0,0,11,0.18181818181818182,0.6363636363636364
70864,2,9,0,0,11,0.18181818181818182,0.6363636363636364
228351,2,9,0,0,11,0.18181818181818182,0.6363636363636364
138995,5,26,0,2,33,0.15151515151515152,0.6363636363636364
62958,2,9,0,0,11,0.18181818181818182,0.6363636363636364
230293,2,9,0,0,11,0.18181818181818182,0.6363636363636364
235498,2,9,0,0,11,0.18181818181818182,0.6363636363636364
179327,2,9,0,0,11,0.18181818181818182,0.6363636363636364
144910,2,9,0,0,11,0.18181818181818182,0.6363636363636364
217318,13,75,0,9,97,0.13402061855670103,0.6391752577319587
172760,2,18,0,5,25,0.08,0.64
40330,3,14,0,0,17,0.17647058823529413,0.6470588235294118
92652,2,13,0,2,17,0.11764705882352941,0.6470588235294118
135703,3,16,0,1,20,0.15,0.65
51526,4,19,0,0,23,0.17391304347826086,0.6521739130434783
140223,4,21,1,0,26,0.15384615384615385,0.6538461538461539
36256,4,21,0,1,26,0.15384615384615385,0.6538461538461539
259901,6,29,0,0,35,0.17142857142857143,0.6571428571428571
77480,4,29,0,5,38,0.10526315789473684,0.6578947368421053
181956,1,5,0,0,6,0.16666666666666666,0.6666666666666666
29419,1,5,0,0,6,0.16666666666666666,0.6666666666666666
65183,1,5,0,0,6,0.16666666666666666,0.6666666666666666
212109,1,5,0,0,6,0.16666666666666666,0.6666666666666666
225002,1,5,0,0,6,0.16666666666666666,0.6666666666666666
182838,3,15,0,0,18,0.16666666666666666,0.6666666666666666
254064,1,5,0,0,6,0.16666666666666666,0.6666666666666666
30749,1,5,0,0,6,0.16666666666666666,0.6666666666666666
266054,1,5,0,0,6,0.16666666666666666,0.6666666666666666
16551,1,5,0,0,6,0.16666666666666666,0.6666666666666666
175117,1,7,0,1,9,0.1111111111111111,0.6666666666666666
16046,1,5,0,0,6,0.16666666666666666,0.6666666666666666
2287,1,5,0,0,6,0.16666666666666666,0.6666666666666666
2288,1,5,0,0,6,0.16666666666666666,0.6666666666666666
213312,1,5,0,0,6,0.16666666666666666,0.6666666666666666
258520,1,5,0,0,6,0.16666666666666666,0.6666666666666666
239801,0,6,0,3,9,0.0,0.6666666666666666
275732,1,5,0,0,6,0.16666666666666666,0.6666666666666666
22503,0,4,0,2,6,0.0,0.6666666666666666
224626,1,5,0,0,6,0.16666666666666666,0.6666666666666666
137803,1,5,0,0,6,0.16666666666666666,0.6666666666666666
51386,1,5,0,0,6,0.16666666666666666,0.6666666666666666
123160,1,5,0,0,6,0.16666666666666666,0.6666666666666666
129338,3,15,0,0,18,0.16666666666666666,0.6666666666666666
85433,1,7,0,1,9,0.1111111111111111,0.6666666666666666
150890,1,5,0,0,6,0.16666666666666666,0.6666666666666666
90657,2,10,0,0,12,0.16666666666666666,0.6666666666666666
65497,1,5,0,0,6,0.16666666666666666,0.6666666666666666
174625,1,5,0,0,6,0.16666666666666666,0.6666666666666666
174918,1,5,0,0,6,0.16666666666666666,0.6666666666666666
277639,2,10,0,0,12,0.16666666666666666,0.6666666666666666
222677,1,5,0,0,6,0.16666666666666666,0.6666666666666666
134784,1,5,0,0,6,0.16666666666666666,0.6666666666666666
123228,1,5,0,0,6,0.16666666666666666,0.6666666666666666
87155,1,5,0,0,6,0.16666666666666666,0.6666666666666666
227295,0,4,0,2,6,0.0,0.6666666666666666
8570,1,5,0,0,6,0.16666666666666666,0.6666666666666666
62239,1,5,0,0,6,0.16666666666666666,0.6666666666666666
88416,1,7,0,1,9,0.1111111111111111,0.6666666666666666
124322,1,5,0,0,6,0.16666666666666666,0.6666666666666666
163169,1,5,0,0,6,0.16666666666666666,0.6666666666666666
101214,1,5,0,0,6,0.16666666666666666,0.6666666666666666
57302,1,5,0,0,6,0.16666666666666666,0.6666666666666666
57369,1,5,0,0,6,0.16666666666666666,0.6666666666666666
60977,1,5,0,0,6,0.16666666666666666,0.6666666666666666
61759,1,5,0,0,6,0.16666666666666666,0.6666666666666666
242247,1,5,0,0,6,0.16666666666666666,0.6666666666666666
134120,1,5,0,0,6,0.16666666666666666,0.6666666666666666
81368,2,14,0,2,18,0.1111111111111111,0.6666666666666666
158846,2,12,0,1,15,0.13333333333333333,0.6666666666666666
207134,1,5,0,0,6,0.16666666666666666,0.6666666666666666
242763,1,5,0,0,6,0.16666666666666666,0.6666666666666666
43901,1,5,0,0,6,0.16666666666666666,0.6666666666666666
89507,1,9,0,2,12,0.08333333333333333,0.6666666666666666
133418,1,5,0,0,6,0.16666666666666666,0.6666666666666666
265553,3,15,0,0,18,0.16666666666666666,0.6666666666666666
264464,1,5,0,0,6,0.16666666666666666,0.6666666666666666
163302,1,5,0,0,6,0.16666666666666666,0.6666666666666666
163194,1,5,0,0,6,0.16666666666666666,0.6666666666666666
80642,2,10,0,0,12,0.16666666666666666,0.6666666666666666
12348,1,5,0,0,6,0.16666666666666666,0.6666666666666666
56917,1,5,0,0,6,0.16666666666666666,0.6666666666666666
134264,1,5,0,0,6,0.16666666666666666,0.6666666666666666
225617,1,5,0,0,6,0.16666666666666666,0.6666666666666666
108392,1,5,0,0,6,0.16666666666666666,0.6666666666666666
245616,1,5,0,0,6,0.16666666666666666,0.6666666666666666
242891,1,5,0,0,6,0.16666666666666666,0.6666666666666666
101731,2,12,0,1,15,0.13333333333333333,0.6666666666666666
96194,1,5,0,0,6,0.16666666666666666,0.6666666666666666
189474,2,10,0,0,12,0.16666666666666666,0.6666666666666666
119418,1,5,0,0,6,0.16666666666666666,0.6666666666666666
159946,1,5,0,0,6,0.16666666666666666,0.6666666666666666
93518,1,5,0,0,6,0.16666666666666666,0.6666666666666666
119654,1,5,0,0,6,0.16666666666666666,0.6666666666666666
236840,1,7,0,1,9,0.1111111111111111,0.6666666666666666
37239,1,5,0,0,6,0.16666666666666666,0.6666666666666666
232103,1,5,0,0,6,0.16666666666666666,0.6666666666666666
75115,0,4,0,2,6,0.0,0.6666666666666666
75485,4,20,0,0,24,0.16666666666666666,0.6666666666666666
237429,1,5,0,0,6,0.16666666666666666,0.6666666666666666
40222,1,5,0,0,6,0.16666666666666666,0.6666666666666666
15021,1,7,0,1,9,0.1111111111111111,0.6666666666666666
143388,1,5,0,0,6,0.16666666666666666,0.6666666666666666
217012,1,5,0,0,6,0.16666666666666666,0.6666666666666666
158043,1,5,0,0,6,0.16666666666666666,0.6666666666666666
139462,0,4,0,2,6,0.0,0.6666666666666666
171904,1,5,0,0,6,0.16666666666666666,0.6666666666666666
249220,1,5,0,0,6,0.16666666666666666,0.6666666666666666
16777,1,5,0,0,6,0.16666666666666666,0.6666666666666666
259264,1,5,0,0,6,0.16666666666666666,0.6666666666666666
220095,1,7,0,1,9,0.1111111111111111,0.6666666666666666
160295,1,11,0,3,15,0.06666666666666667,0.6666666666666666
234675,1,9,0,2,12,0.08333333333333333,0.6666666666666666
38457,1,5,0,0,6,0.16666666666666666,0.6666666666666666
235059,1,5,0,0,6,0.16666666666666666,0.6666666666666666
235384,1,5,0,0,6,0.16666666666666666,0.6666666666666666
23459,1,5,0,0,6,0.16666666666666666,0.6666666666666666
196457,1,5,0,0,6,0.16666666666666666,0.6666666666666666
94630,1,5,0,0,6,0.16666666666666666,0.6666666666666666
41080,1,5,0,0,6,0.16666666666666666,0.6666666666666666
20794,1,5,0,0,6,0.16666666666666666,0.6666666666666666
196146,1,5,0,0,6,0.16666666666666666,0.6666666666666666
119027,1,5,0,0,6,0.16666666666666666,0.6666666666666666
142671,1,5,0,0,6,0.16666666666666666,0.6666666666666666
22813,1,7,0,1,9,0.1111111111111111,0.6666666666666666
69512,1,5,0,0,6,0.16666666666666666,0.6666666666666666
39353,1,5,0,0,6,0.16666666666666666,0.6666666666666666
257625,1,5,0,0,6,0.16666666666666666,0.6666666666666666
16755,1,5,0,0,6,0.16666666666666666,0.6666666666666666
5963,1,5,0,0,6,0.16666666666666666,0.6666666666666666
191575,1,5,0,0,6,0.16666666666666666,0.6666666666666666
20388,1,5,0,0,6,0.16666666666666666,0.6666666666666666
139126,2,10,0,0,12,0.16666666666666666,0.6666666666666666
42883,1,5,0,0,6,0.16666666666666666,0.6666666666666666
42847,1,5,0,0,6,0.16666666666666666,0.6666666666666666
34087,2,10,0,0,12,0.16666666666666666,0.6666666666666666
107044,0,4,0,2,6,0.0,0.6666666666666666
189541,1,5,0,0,6,0.16666666666666666,0.6666666666666666
266466,3,15,0,0,18,0.16666666666666666,0.6666666666666666
204255,1,5,0,0,6,0.16666666666666666,0.6666666666666666
98320,1,5,0,0,6,0.16666666666666666,0.6666666666666666
7352,1,7,0,1,9,0.1111111111111111,0.6666666666666666
42450,1,5,0,0,6,0.16666666666666666,0.6666666666666666
203844,0,4,0,2,6,0.0,0.6666666666666666
191166,1,5,0,0,6,0.16666666666666666,0.6666666666666666
144455,1,7,0,1,9,0.1111111111111111,0.6666666666666666
138097,2,14,1,1,18,0.1111111111111111,0.6666666666666666
115833,1,5,0,0,6,0.16666666666666666,0.6666666666666666
35841,1,5,0,0,6,0.16666666666666666,0.6666666666666666
144229,1,5,0,0,6,0.16666666666666666,0.6666666666666666
230687,1,5,0,0,6,0.16666666666666666,0.6666666666666666
25583,2,10,0,0,12,0.16666666666666666,0.6666666666666666
216501,1,5,0,0,6,0.16666666666666666,0.6666666666666666
128085,8,41,0,0,49,0.16326530612244897,0.673469387755102
196738,8,42,0,0,50,0.16,0.68
37400,3,18,0,1,22,0.13636363636363635,0.6818181818181818
273976,3,18,0,1,22,0.13636363636363635,0.6818181818181818
228998,3,18,0,1,22,0.13636363636363635,0.6818181818181818
222204,2,13,0,1,16,0.125,0.6875
93364,2,13,0,1,16,0.125,0.6875
189558,6,35,0,1,42,0.14285714285714285,0.6904761904761905
94951,6,33,0,0,39,0.15384615384615385,0.6923076923076923
94923,2,11,0,0,13,0.15384615384615385,0.6923076923076923
229331,2,11,0,0,13,0.15384615384615385,0.6923076923076923
134761,2,11,0,0,13,0.15384615384615385,0.6923076923076923
210597,2,11,0,0,13,0.15384615384615385,0.6923076923076923
238419,2,11,0,0,13,0.15384615384615385,0.6923076923076923
228021,7,39,0,0,46,0.15217391304347827,0.6956521739130435
33124,4,41,0,8,53,0.07547169811320754,0.6981132075471698
240318,1,8,0,1,10,0.1,0.7
267184,1,8,0,1,10,0.1,0.7
219321,3,17,0,0,20,0.15,0.7
170227,0,7,0,3,10,0.0,0.7
59971,1,8,0,1,10,0.1,0.7
274634,3,17,0,0,20,0.15,0.7
124079,1,8,0,1,10,0.1,0.7
41403,1,8,0,1,10,0.1,0.7
50849,1,8,0,1,10,0.1,0.7
228445,1,8,0,1,10,0.1,0.7
123460,2,14,0,1,17,0.11764705882352941,0.7058823529411765
91184,5,29,0,0,34,0.14705882352941177,0.7058823529411765
83431,3,20,0,1,24,0.125,0.7083333333333334
258152,2,39,0,11,52,0.038461538461538464,0.7115384615384616
157625,1,6,0,0,7,0.14285714285714285,0.7142857142857143
224342,1,6,0,0,7,0.14285714285714285,0.7142857142857143
135043,2,12,0,0,14,0.14285714285714285,0.7142857142857143
179688,1,6,0,0,7,0.14285714285714285,0.7142857142857143
94952,1,6,0,0,7,0.14285714285714285,0.7142857142857143
107523,1,6,0,0,7,0.14285714285714285,0.7142857142857143
85992,1,6,0,0,7,0.14285714285714285,0.7142857142857143
157281,1,6,0,0,7,0.14285714285714285,0.7142857142857143
211303,1,6,0,0,7,0.14285714285714285,0.7142857142857143
244349,1,6,0,0,7,0.14285714285714285,0.7142857142857143
106946,1,6,0,0,7,0.14285714285714285,0.7142857142857143
277157,2,12,0,0,14,0.14285714285714285,0.7142857142857143
50141,2,12,0,0,14,0.14285714285714285,0.7142857142857143
12863,1,6,0,0,7,0.14285714285714285,0.7142857142857143
248805,1,6,0,0,7,0.14285714285714285,0.7142857142857143
133957,1,6,0,0,7,0.14285714285714285,0.7142857142857143
161744,1,6,0,0,7,0.14285714285714285,0.7142857142857143
277629,1,6,0,0,7,0.14285714285714285,0.7142857142857143
89852,1,6,0,0,7,0.14285714285714285,0.7142857142857143
127024,1,6,0,0,7,0.14285714285714285,0.7142857142857143
213197,1,6,0,0,7,0.14285714285714285,0.7142857142857143
87579,1,6,0,0,7,0.14285714285714285,0.7142857142857143
218514,1,6,0,0,7,0.14285714285714285,0.7142857142857143
130482,2,12,0,0,14,0.14285714285714285,0.7142857142857143
88605,1,6,0,0,7,0.14285714285714285,0.7142857142857143
168036,2,12,0,0,14,0.14285714285714285,0.7142857142857143
220091,1,6,0,0,7,0.14285714285714285,0.7142857142857143
95452,1,6,0,0,7,0.14285714285714285,0.7142857142857143
53042,1,6,0,0,7,0.14285714285714285,0.7142857142857143
155807,1,6,0,0,7,0.14285714285714285,0.7142857142857143
219974,1,6,0,0,7,0.14285714285714285,0.7142857142857143
102117,1,6,0,0,7,0.14285714285714285,0.7142857142857143
70931,1,11,0,2,14,0.07142857142857142,0.7142857142857143
136396,1,6,0,0,7,0.14285714285714285,0.7142857142857143
43004,1,6,0,0,7,0.14285714285714285,0.7142857142857143
61798,2,12,0,0,14,0.14285714285714285,0.7142857142857143
207924,1,6,0,0,7,0.14285714285714285,0.7142857142857143
185450,1,6,0,0,7,0.14285714285714285,0.7142857142857143
207385,1,6,0,0,7,0.14285714285714285,0.7142857142857143
103467,1,6,0,0,7,0.14285714285714285,0.7142857142857143
265504,1,6,0,0,7,0.14285714285714285,0.7142857142857143
167189,1,6,0,0,7,0.14285714285714285,0.7142857142857143
44663,1,6,0,0,7,0.14285714285714285,0.7142857142857143
114089,1,6,0,0,7,0.14285714285714285,0.7142857142857143
163579,1,6,0,0,7,0.14285714285714285,0.7142857142857143
228245,1,6,0,0,7,0.14285714285714285,0.7142857142857143
188027,1,6,0,0,7,0.14285714285714285,0.7142857142857143
204622,1,6,0,0,7,0.14285714285714285,0.7142857142857143
239736,0,5,0,2,7,0.0,0.7142857142857143
31471,1,6,0,0,7,0.14285714285714285,0.7142857142857143
161039,2,17,0,2,21,0.09523809523809523,0.7142857142857143
190080,1,6,0,0,7,0.14285714285714285,0.7142857142857143
164549,1,6,0,0,7,0.14285714285714285,0.7142857142857143
121251,2,12,0,0,14,0.14285714285714285,0.7142857142857143
267326,1,6,0,0,7,0.14285714285714285,0.7142857142857143
143302,1,6,0,0,7,0.14285714285714285,0.7142857142857143
267596,1,6,0,0,7,0.14285714285714285,0.7142857142857143
232292,1,6,0,0,7,0.14285714285714285,0.7142857142857143
73622,1,6,0,0,7,0.14285714285714285,0.7142857142857143
195049,1,6,0,0,7,0.14285714285714285,0.7142857142857143
6345,1,6,0,0,7,0.14285714285714285,0.7142857142857143
72287,1,6,0,0,7,0.14285714285714285,0.7142857142857143
200585,0,5,0,2,7,0.0,0.7142857142857143
20961,1,6,0,0,7,0.14285714285714285,0.7142857142857143
165866,3,18,0,0,21,0.14285714285714285,0.7142857142857143
34115,1,6,0,0,7,0.14285714285714285,0.7142857142857143
112914,1,6,0,0,7,0.14285714285714285,0.7142857142857143
144062,1,6,0,0,7,0.14285714285714285,0.7142857142857143
148191,1,6,0,0,7,0.14285714285714285,0.7142857142857143
8971,1,6,0,0,7,0.14285714285714285,0.7142857142857143
209147,1,6,0,0,7,0.14285714285714285,0.7142857142857143
124048,1,6,0,0,7,0.14285714285714285,0.7142857142857143
59504,1,6,0,0,7,0.14285714285714285,0.7142857142857143
183883,1,6,0,0,7,0.14285714285714285,0.7142857142857143
251146,1,6,0,0,7,0.14285714285714285,0.7142857142857143
184121,1,6,0,0,7,0.14285714285714285,0.7142857142857143
136136,1,6,0,0,7,0.14285714285714285,0.7142857142857143
182275,1,6,0,0,7,0.14285714285714285,0.7142857142857143
212467,3,21,0,1,25,0.12,0.72
159506,8,52,0,1,61,0.13114754098360656,0.7213114754098361
143964,2,15,0,1,18,0.1111111111111111,0.7222222222222222
56856,5,31,0,0,36,0.1388888888888889,0.7222222222222222
225595,7,44,0,0,51,0.13725490196078433,0.7254901960784313
93034,1,9,0,1,11,0.09090909090909091,0.7272727272727273
217468,3,19,0,0,22,0.13636363636363635,0.7272727272727273
230496,1,9,0,1,11,0.09090909090909091,0.7272727272727273
217106,1,9,0,1,11,0.09090909090909091,0.7272727272727273
173679,5,32,0,0,37,0.13513513513513514,0.7297297297297297
212849,2,13,0,0,15,0.13333333333333333,0.7333333333333333
171968,1,12,0,2,15,0.06666666666666667,0.7333333333333333
158606,2,13,0,0,15,0.13333333333333333,0.7333333333333333
142584,2,13,0,0,15,0.13333333333333333,0.7333333333333333
90049,2,13,0,0,15,0.13333333333333333,0.7333333333333333
3145,2,13,0,0,15,0.13333333333333333,0.7333333333333333
113030,1,15,0,3,19,0.05263157894736842,0.7368421052631579
106768,3,20,0,0,23,0.13043478260869565,0.7391304347826086
210959,4,33,0,2,39,0.10256410256410256,0.7435897435897436
154354,1,7,0,0,8,0.125,0.75
155913,2,14,0,0,16,0.125,0.75
121167,1,7,0,0,8,0.125,0.75
158506,1,7,0,0,8,0.125,0.75
62172,1,7,0,0,8,0.125,0.75
240789,1,7,0,0,8,0.125,0.75
192119,1,13,0,2,16,0.0625,0.75
248259,1,7,0,0,8,0.125,0.75
75809,1,7,0,0,8,0.125,0.75
8864,1,7,0,0,8,0.125,0.75
118628,2,17,0,1,20,0.1,0.75
254995,1,7,0,0,8,0.125,0.75
8695,1,7,0,0,8,0.125,0.75
36978,1,7,0,0,8,0.125,0.75
110110,1,7,0,0,8,0.125,0.75
54652,1,7,0,0,8,0.125,0.75
4197,1,7,0,0,8,0.125,0.75
103445,1,7,0,0,8,0.125,0.75
259057,1,7,0,0,8,0.125,0.75
72418,1,7,0,0,8,0.125,0.75
46295,1,7,0,0,8,0.125,0.75
201323,1,7,0,0,8,0.125,0.75
148028,1,7,0,0,8,0.125,0.75
253949,2,14,0,0,16,0.125,0.75
15144,1,7,0,0,8,0.125,0.75
149483,2,14,0,0,16,0.125,0.75
268786,1,7,0,0,8,0.125,0.75
117963,1,7,0,0,8,0.125,0.75
198011,1,7,0,0,8,0.125,0.75
38250,1,7,0,0,8,0.125,0.75
213119,1,10,0,1,12,0.08333333333333333,0.75
81434,1,7,0,0,8,0.125,0.75
55398,1,7,0,0,8,0.125,0.75
136735,1,7,0,0,8,0.125,0.75
95226,1,7,0,0,8,0.125,0.75
271622,2,17,0,1,20,0.1,0.75
266478,1,7,0,0,8,0.125,0.75
243058,2,17,0,1,20,0.1,0.75
27383,0,6,0,2,8,0.0,0.75
161348,1,7,0,0,8,0.125,0.75
108267,1,7,0,0,8,0.125,0.75
188379,1,7,0,0,8,0.125,0.75
212439,1,7,0,0,8,0.125,0.75
89867,1,7,0,0,8,0.125,0.75
240370,2,14,0,0,16,0.125,0.75
264600,0,6,0,2,8,0.0,0.75
79977,2,17,0,1,20,0.1,0.75
273197,1,7,0,0,8,0.125,0.75
201042,4,29,0,0,33,0.12121212121212122,0.7575757575757576
117384,3,22,0,0,25,0.12,0.76
201776,2,21,0,2,25,0.08,0.76
60263,2,18,0,1,21,0.09523809523809523,0.7619047619047619
252820,6,48,0,1,55,0.10909090909090909,0.7636363636363637
61147,2,15,0,0,17,0.11764705882352941,0.7647058823529411
77724,2,15,0,0,17,0.11764705882352941,0.7647058823529411
181077,2,15,0,0,17,0.11764705882352941,0.7647058823529411
109779,4,30,0,0,34,0.11764705882352941,0.7647058823529411
37512,2,15,0,0,17,0.11764705882352941,0.7647058823529411
26145,1,11,0,1,13,0.07692307692307693,0.7692307692307693
271531,1,11,0,1,13,0.07692307692307693,0.7692307692307693
266355,1,11,0,1,13,0.07692307692307693,0.7692307692307693
276313,1,11,0,1,13,0.07692307692307693,0.7692307692307693
219683,9,83,0,4,96,0.09375,0.7708333333333334
161831,1,8,0,0,9,0.1111111111111111,0.7777777777777778
25545,1,8,0,0,9,0.1111111111111111,0.7777777777777778
69211,2,23,0,2,27,0.07407407407407407,0.7777777777777778
18311,1,8,0,0,9,0.1111111111111111,0.7777777777777778
141089,1,8,0,0,9,0.1111111111111111,0.7777777777777778
108336,1,8,0,0,9,0.1111111111111111,0.7777777777777778
198767,1,8,0,0,9,0.1111111111111111,0.7777777777777778
135653,1,8,0,0,9,0.1111111111111111,0.7777777777777778
98923,1,8,0,0,9,0.1111111111111111,0.7777777777777778
141819,0,7,0,2,9,0.0,0.7777777777777778
92398,1,8,0,0,9,0.1111111111111111,0.7777777777777778
95525,0,7,0,2,9,0.0,0.7777777777777778
65484,1,8,0,0,9,0.1111111111111111,0.7777777777777778
228738,1,8,0,0,9,0.1111111111111111,0.7777777777777778
210168,1,8,0,0,9,0.1111111111111111,0.7777777777777778
164492,1,8,0,0,9,0.1111111111111111,0.7777777777777778
93698,0,7,0,2,9,0.0,0.7777777777777778
248064,1,8,0,0,9,0.1111111111111111,0.7777777777777778
7887,1,8,0,0,9,0.1111111111111111,0.7777777777777778
145369,2,16,0,0,18,0.1111111111111111,0.7777777777777778
221543,1,8,0,0,9,0.1111111111111111,0.7777777777777778
123625,1,8,0,0,9,0.1111111111111111,0.7777777777777778
229681,1,8,0,0,9,0.1111111111111111,0.7777777777777778
1903,1,8,0,0,9,0.1111111111111111,0.7777777777777778
110558,1,8,0,0,9,0.1111111111111111,0.7777777777777778
143134,1,8,0,0,9,0.1111111111111111,0.7777777777777778
41084,3,35,0,3,41,0.07317073170731707,0.7804878048780488
232052,1,12,0,1,14,0.07142857142857142,0.7857142857142857
104880,1,12,0,1,14,0.07142857142857142,0.7857142857142857
97324,2,17,0,0,19,0.10526315789473684,0.7894736842105263
35704,2,17,0,0,19,0.10526315789473684,0.7894736842105263
254822,2,18,0,0,20,0.1,0.8
95261,0,4,0,1,5,0.0,0.8
97972,0,4,0,1,5,0.0,0.8
251483,0,4,0,1,5,0.0,0.8
28144,1,9,0,0,10,0.1,0.8
94519,0,4,0,1,5,0.0,0.8
265932,0,4,0,1,5,0.0,0.8
190789,0,4,0,1,5,0.0,0.8
117925,1,9,0,0,10,0.1,0.8
49262,0,4,0,1,5,0.0,0.8
197664,0,4,0,1,5,0.0,0.8
198483,1,9,0,0,10,0.1,0.8
4483,0,4,0,1,5,0.0,0.8
68886,1,9,0,0,10,0.1,0.8
232736,0,4,0,1,5,0.0,0.8
3917,1,13,0,1,15,0.06666666666666667,0.8
55631,1,9,0,0,10,0.1,0.8
215498,0,4,0,1,5,0.0,0.8
121065,0,4,0,1,5,0.0,0.8
230030,1,9,0,0,10,0.1,0.8
270897,1,9,0,0,10,0.1,0.8
66797,0,4,0,1,5,0.0,0.8
56369,0,4,0,1,5,0.0,0.8
204333,0,4,0,1,5,0.0,0.8
65238,0,4,0,1,5,0.0,0.8
223066,0,4,0,1,5,0.0,0.8
206393,1,9,0,0,10,0.1,0.8
271833,0,4,0,1,5,0.0,0.8
123433,0,4,0,1,5,0.0,0.8
60445,1,9,0,0,10,0.1,0.8
223721,0,4,0,1,5,0.0,0.8
32599,2,18,0,0,20,0.1,0.8
265546,0,4,0,1,5,0.0,0.8
130581,1,9,0,0,10,0.1,0.8
57713,1,9,0,0,10,0.1,0.8
111133,1,9,0,0,10,0.1,0.8
173684,1,9,0,0,10,0.1,0.8
82751,0,4,0,1,5,0.0,0.8
24960,0,4,0,1,5,0.0,0.8
90793,0,4,0,1,5,0.0,0.8
27091,1,9,0,0,10,0.1,0.8
84201,0,4,0,1,5,0.0,0.8
244039,0,4,0,1,5,0.0,0.8
154553,1,9,0,0,10,0.1,0.8
27888,0,4,0,1,5,0.0,0.8
109403,0,4,0,1,5,0.0,0.8
263842,0,8,0,2,10,0.0,0.8
156432,0,4,0,1,5,0.0,0.8
181948,0,4,0,1,5,0.0,0.8
66574,3,28,0,0,31,0.0967741935483871,0.8064516129032258
255078,2,19,0,0,21,0.09523809523809523,0.8095238095238095
116122,1,10,0,0,11,0.09090909090909091,0.8181818181818182
176348,1,10,0,0,11,0.09090909090909091,0.8181818181818182
161041,2,29,0,2,33,0.06060606060606061,0.8181818181818182
113983,1,10,0,0,11,0.09090909090909091,0.8181818181818182
49225,2,20,0,0,22,0.09090909090909091,0.8181818181818182
79923,1,10,0,0,11,0.09090909090909091,0.8181818181818182
204696,1,10,0,0,11,0.09090909090909091,0.8181818181818182
163570,5,51,0,0,56,0.08928571428571429,0.8214285714285714
98758,3,49,0,4,56,0.05357142857142857,0.8214285714285714
70541,2,21,0,0,23,0.08695652173913043,0.8260869565217391
88652,2,21,0,0,23,0.08695652173913043,0.8260869565217391
51207,1,11,0,0,12,0.08333333333333333,0.8333333333333334
62881,1,11,0,0,12,0.08333333333333333,0.8333333333333334
161476,0,5,0,1,6,0.0,0.8333333333333334
163335,0,5,0,1,6,0.0,0.8333333333333334
277042,0,5,0,1,6,0.0,0.8333333333333334
225199,4,44,0,0,48,0.08333333333333333,0.8333333333333334
211231,1,11,0,0,12,0.08333333333333333,0.8333333333333334
154176,0,5,0,1,6,0.0,0.8333333333333334
57935,0,5,0,1,6,0.0,0.8333333333333334
261590,0,5,0,1,6,0.0,0.8333333333333334
176597,1,11,0,0,12,0.08333333333333333,0.8333333333333334
277623,0,5,0,1,6,0.0,0.8333333333333334
221753,1,11,0,0,12,0.08333333333333333,0.8333333333333334
165073,0,5,0,1,6,0.0,0.8333333333333334
69089,0,5,0,1,6,0.0,0.8333333333333334
112148,0,5,0,1,6,0.0,0.8333333333333334
97179,1,11,0,0,12,0.08333333333333333,0.8333333333333334
221687,0,5,0,1,6,0.0,0.8333333333333334
269011,0,5,0,1,6,0.0,0.8333333333333334
187763,0,5,0,1,6,0.0,0.8333333333333334
188796,0,5,0,1,6,0.0,0.8333333333333334
116816,0,5,0,1,6,0.0,0.8333333333333334
141600,0,5,0,1,6,0.0,0.8333333333333334
128060,1,16,0,1,18,0.05555555555555555,0.8333333333333334
215942,0,5,0,1,6,0.0,0.8333333333333334
236269,0,5,0,1,6,0.0,0.8333333333333334
206202,0,21,0,4,25,0.0,0.84
52011,2,23,0,0,25,0.08,0.84
260316,1,12,0,0,13,0.07692307692307693,0.8461538461538461
86392,1,12,0,0,13,0.07692307692307693,0.8461538461538461
55027,1,12,0,0,13,0.07692307692307693,0.8461538461538461
255092,1,12,0,0,13,0.07692307692307693,0.8461538461538461
165758,4,48,0,0,52,0.07692307692307693,0.8461538461538461
123510,1,12,0,0,13,0.07692307692307693,0.8461538461538461
145109,1,12,0,0,13,0.07692307692307693,0.8461538461538461
267282,1,12,0,0,13,0.07692307692307693,0.8461538461538461
61257,1,12,0,0,13,0.07692307692307693,0.8461538461538461
72575,1,12,0,0,13,0.07692307692307693,0.8461538461538461
128332,1,12,0,0,13,0.07692307692307693,0.8461538461538461
95025,1,12,0,0,13,0.07692307692307693,0.8461538461538461
84900,1,12,0,0,13,0.07692307692307693,0.8461538461538461
184299,5,64,0,0,69,0.07246376811594203,0.855072463768116
132282,1,13,0,0,14,0.07142857142857142,0.8571428571428571
276307,0,12,0,2,14,0.0,0.8571428571428571
213625,0,6,0,1,7,0.0,0.8571428571428571
201557,0,6,0,1,7,0.0,0.8571428571428571
1848,1,13,0,0,14,0.07142857142857142,0.8571428571428571
171602,1,13,0,0,14,0.07142857142857142,0.8571428571428571
246512,1,13,0,0,14,0.07142857142857142,0.8571428571428571
29570,0,6,0,1,7,0.0,0.8571428571428571
240906,1,13,0,0,14,0.07142857142857142,0.8571428571428571
235506,1,13,0,0,14,0.07142857142857142,0.8571428571428571
250101,1,13,0,0,14,0.07142857142857142,0.8571428571428571
20250,0,6,0,1,7,0.0,0.8571428571428571
202173,0,6,0,1,7,0.0,0.8571428571428571
102220,1,13,0,0,14,0.07142857142857142,0.8571428571428571
103656,0,6,0,1,7,0.0,0.8571428571428571
137816,1,13,0,0,14,0.07142857142857142,0.8571428571428571
228579,1,13,0,0,14,0.07142857142857142,0.8571428571428571
123154,0,6,0,1,7,0.0,0.8571428571428571
212385,1,14,0,0,15,0.06666666666666667,0.8666666666666667
199416,2,28,0,0,30,0.06666666666666667,0.8666666666666667
195386,1,14,0,0,15,0.06666666666666667,0.8666666666666667
206438,1,14,0,0,15,0.06666666666666667,0.8666666666666667
169824,1,14,0,0,15,0.06666666666666667,0.8666666666666667
70666,3,51,0,1,55,0.05454545454545454,0.8727272727272727
114085,1,15,0,0,16,0.0625,0.875
133935,1,15,0,0,16,0.0625,0.875
274423,0,7,0,1,8,0.0,0.875
256023,0,7,0,1,8,0.0,0.875
120332,0,7,0,1,8,0.0,0.875
3578,0,7,0,1,8,0.0,0.875
53520,0,7,0,1,8,0.0,0.875
50859,0,7,0,1,8,0.0,0.875
235895,1,15,0,0,16,0.0625,0.875
168971,0,7,0,1,8,0.0,0.875
244874,0,7,0,1,8,0.0,0.875
252846,0,7,0,1,8,0.0,0.875
166391,1,15,0,0,16,0.0625,0.875
53069,0,7,0,1,8,0.0,0.875
43157,0,7,1,0,8,0.0,0.875
67627,1,15,0,0,16,0.0625,0.875
61910,1,16,0,0,17,0.058823529411764705,0.8823529411764706
250709,1,31,0,2,34,0.029411764705882353,0.8823529411764706
274549,1,16,0,0,17,0.058823529411764705,0.8823529411764706
6238,1,16,0,0,17,0.058823529411764705,0.8823529411764706
33179,1,16,0,0,17,0.058823529411764705,0.8823529411764706
69721,1,17,0,0,18,0.05555555555555555,0.8888888888888888
95043,0,8,0,1,9,0.0,0.8888888888888888
33832,0,8,0,1,9,0.0,0.8888888888888888
234672,0,8,0,1,9,0.0,0.8888888888888888
231149,0,8,0,1,9,0.0,0.8888888888888888
68846,0,8,0,1,9,0.0,0.8888888888888888
259078,0,8,0,1,9,0.0,0.8888888888888888
43021,0,8,0,1,9,0.0,0.8888888888888888
86242,0,8,0,1,9,0.0,0.8888888888888888
109901,3,53,0,0,56,0.05357142857142857,0.8928571428571429
112953,1,18,0,0,19,0.05263157894736842,0.8947368421052632
25601,1,18,0,0,19,0.05263157894736842,0.8947368421052632
79215,0,9,0,1,10,0.0,0.9
241086,0,9,0,1,10,0.0,0.9
69684,1,19,0,0,20,0.05,0.9
265607,0,9,0,1,10,0.0,0.9
129489,1,19,0,0,20,0.05,0.9
91491,0,9,0,1,10,0.0,0.9
3556,0,9,0,1,10,0.0,0.9
134434,2,40,0,0,42,0.047619047619047616,0.9047619047619048
110361,1,20,0,0,21,0.047619047619047616,0.9047619047619048
86408,1,20,0,0,21,0.047619047619047616,0.9047619047619048
99441,0,19,0,2,21,0.0,0.9047619047619048
49422,1,21,0,0,22,0.045454545454545456,0.9090909090909091
10118,0,10,0,1,11,0.0,0.9090909090909091
68436,1,32,0,1,34,0.029411764705882353,0.9117647058823529
269386,0,11,0,1,12,0.0,0.9166666666666666
95574,0,11,0,1,12,0.0,0.9166666666666666
212797,1,24,0,0,25,0.04,0.92
214786,3,86,0,1,90,0.03333333333333333,0.9222222222222223
164533,0,12,0,1,13,0.0,0.9230769230769231
251739,0,12,0,1,13,0.0,0.9230769230769231
163202,1,26,0,0,27,0.037037037037037035,0.9259259259259259
158433,2,58,0,0,60,0.03333333333333333,0.9333333333333333
150124,0,16,0,1,17,0.0,0.9411764705882353
32569,0,19,0,1,20,0.0,0.95
67487,0,6,0,0,6,0.0,1.0
66556,0,6,0,0,6,0.0,1.0
66473,0,5,0,0,5,0.0,1.0
67354,0,8,0,0,8,0.0,1.0
230180,0,5,0,0,5,0.0,1.0
204929,0,6,0,0,6,0.0,1.0
231251,0,6,0,0,6,0.0,1.0
65370,0,5,0,0,5,0.0,1.0
139421,0,5,0,0,5,0.0,1.0
202212,0,6,0,0,6,0.0,1.0
68128,0,24,0,0,24,0.0,1.0
231374,0,7,0,0,7,0.0,1.0
120548,0,7,0,0,7,0.0,1.0
231225,0,5,0,0,5,0.0,1.0
202711,0,14,0,0,14,0.0,1.0
204179,0,5,0,0,5,0.0,1.0
138674,0,6,0,0,6,0.0,1.0
120985,0,5,0,0,5,0.0,1.0
138813,0,5,0,0,5,0.0,1.0
203441,0,8,0,0,8,0.0,1.0
202358,0,8,0,0,8,0.0,1.0
270754,0,5,0,0,5,0.0,1.0
138330,0,5,0,0,5,0.0,1.0
122386,0,7,0,0,7,0.0,1.0
67178,0,7,0,0,7,0.0,1.0
120829,0,7,0,0,7,0.0,1.0
67296,0,8,0,0,8,0.0,1.0
122784,0,7,0,0,7,0.0,1.0
66789,0,9,0,0,9,0.0,1.0
122883,0,6,0,0,6,0.0,1.0
66853,0,6,0,0,6,0.0,1.0
202706,0,8,0,0,8,0.0,1.0
254690,0,5,0,0,5,0.0,1.0
68344,0,5,0,0,5,0.0,1.0
71102,0,12,0,0,12,0.0,1.0
71162,0,7,0,0,7,0.0,1.0
196886,0,8,0,0,8,0.0,1.0
196621,0,7,0,0,7,0.0,1.0
142212,0,16,0,0,16,0.0,1.0
71522,0,5,0,0,5,0.0,1.0
235884,0,11,0,0,11,0.0,1.0
142442,0,7,0,0,7,0.0,1.0
196148,0,15,0,0,15,0.0,1.0
117557,0,5,0,0,5,0.0,1.0
236017,0,8,0,0,8,0.0,1.0
196108,0,21,0,0,21,0.0,1.0
142672,0,6,0,0,6,0.0,1.0
117489,0,5,0,0,5,0.0,1.0
71628,0,10,0,0,10,0.0,1.0
37623,0,12,0,0,12,0.0,1.0
37584,0,5,0,0,5,0.0,1.0
195079,0,6,0,0,6,0.0,1.0
236754,0,9,0,0,9,0.0,1.0
234893,0,7,0,0,7,0.0,1.0
197424,0,12,0,0,12,0.0,1.0
70435,0,6,0,0,6,0.0,1.0
118654,0,6,0,0,6,0.0,1.0
201760,0,6,0,0,6,0.0,1.0
139586,0,8,0,0,8,0.0,1.0
201751,0,5,0,0,5,0.0,1.0
139934,0,5,0,0,5,0.0,1.0
140167,0,8,0,0,8,0.0,1.0
68447,0,6,0,0,6,0.0,1.0
68537,0,8,0,0,8,0.0,1.0
65228,0,14,0,0,14,0.0,1.0
232492,0,6,0,0,6,0.0,1.0
68249,0,12,0,0,12,0.0,1.0
232708,0,7,0,0,7,0.0,1.0
200493,0,6,0,0,6,0.0,1.0
39284,0,6,0,0,6,0.0,1.0
39227,0,15,0,0,15,0.0,1.0
118881,0,6,0,0,6,0.0,1.0
69929,0,5,0,0,5,0.0,1.0
70222,0,5,0,0,5,0.0,1.0
70302,0,6,0,0,6,0.0,1.0
198557,0,8,0,0,8,0.0,1.0
198216,0,7,0,0,7,0.0,1.0
4334,0,6,0,0,6,0.0,1.0
4098,0,6,0,0,6,0.0,1.0
272385,0,5,0,0,5,0.0,1.0
205554,0,6,0,0,6,0.0,1.0
222743,0,8,0,0,8,0.0,1.0
214315,0,18,0,0,18,0.0,1.0
223078,0,5,0,0,5,0.0,1.0
50681,0,11,0,0,11,0.0,1.0
50650,0,5,0,0,5,0.0,1.0
132716,0,5,0,0,5,0.0,1.0
126232,0,5,0,0,5,0.0,1.0
133225,0,5,0,0,5,0.0,1.0
223156,0,14,0,0,14,0.0,1.0
50615,0,5,0,0,5,0.0,1.0
133682,0,6,0,0,6,0.0,1.0
57095,0,10,0,0,10,0.0,1.0
125171,0,5,0,0,5,0.0,1.0
213664,0,5,0,0,5,0.0,1.0
49423,0,5,0,0,5,0.0,1.0
134118,0,6,0,0,6,0.0,1.0
57632,0,5,0,0,5,0.0,1.0
124888,0,5,0,0,5,0.0,1.0
134247,0,11,0,0,11,0.0,1.0
223644,0,31,0,0,31,0.0,1.0
212859,0,10,0,0,10,0.0,1.0
275439,0,7,0,0,7,0.0,1.0
277710,0,6,0,0,6,0.0,1.0
56272,0,9,0,0,9,0.0,1.0
56157,0,8,0,0,8,0.0,1.0
219353,0,5,0,0,5,0.0,1.0
53575,0,8,0,0,8,0.0,1.0
218836,0,5,0,0,5,0.0,1.0
218689,0,5,0,0,5,0.0,1.0
54290,0,6,0,0,6,0.0,1.0
54492,0,7,0,0,7,0.0,1.0
52887,0,5,0,0,5,0.0,1.0
217107,0,14,0,0,14,0.0,1.0
221368,0,5,0,0,5,0.0,1.0
130636,0,6,0,0,6,0.0,1.0
134556,0,13,0,0,13,0.0,1.0
52141,0,6,0,0,6,0.0,1.0
216386,0,10,0,0,10,0.0,1.0
276038,0,11,0,0,11,0.0,1.0
216151,0,5,0,0,5,0.0,1.0
55559,0,5,0,0,5,0.0,1.0
131510,0,6,0,0,6,0.0,1.0
222034,0,5,0,0,5,0.0,1.0
275761,0,5,0,0,5,0.0,1.0
131617,0,5,0,0,5,0.0,1.0
51403,0,5,0,0,5,0.0,1.0
131657,0,7,0,0,7,0.0,1.0
216495,0,7,0,0,7,0.0,1.0
134630,0,5,0,0,5,0.0,1.0
134694,0,5,0,0,5,0.0,1.0
274111,0,5,0,0,5,0.0,1.0
60546,0,12,0,0,12,0.0,1.0
272961,0,6,0,0,6,0.0,1.0
46350,0,6,0,0,6,0.0,1.0
226349,0,7,0,0,7,0.0,1.0
208468,0,5,0,0,5,0.0,1.0
136829,0,8,0,0,8,0.0,1.0
61042,0,7,0,0,7,0.0,1.0
62316,0,6,0,0,6,0.0,1.0
137134,0,5,0,0,5,0.0,1.0
137137,0,14,0,0,14,0.0,1.0
208620,0,7,0,0,7,0.0,1.0
137143,0,5,0,0,5,0.0,1.0
62471,0,5,0,0,5,0.0,1.0
227146,0,5,0,0,5,0.0,1.0
62688,0,8,0,0,8,0.0,1.0
227282,0,7,0,0,7,0.0,1.0
62968,0,5,0,0,5,0.0,1.0
206691,0,14,0,0,14,0.0,1.0
44472,0,8,0,0,8,0.0,1.0
205943,0,6,0,0,6,0.0,1.0
137434,0,6,0,0,6,0.0,1.0
227925,0,6,0,0,6,0.0,1.0
194636,0,7,0,0,7,0.0,1.0
205426,0,5,0,0,5,0.0,1.0
208788,0,5,0,0,5,0.0,1.0
46671,0,9,0,0,9,0.0,1.0
212719,0,5,0,0,5,0.0,1.0
57959,0,6,0,0,6,0.0,1.0
212628,0,14,0,0,14,0.0,1.0
224146,0,12,0,0,12,0.0,1.0
57960,0,5,0,0,5,0.0,1.0
212130,0,8,0,0,8,0.0,1.0
124488,0,5,0,0,5,0.0,1.0
58529,0,12,0,0,12,0.0,1.0
58708,0,5,0,0,5,0.0,1.0
58792,0,8,0,0,8,0.0,1.0
60130,0,5,0,0,5,0.0,1.0
210738,0,11,0,0,11,0.0,1.0
210627,0,5,0,0,5,0.0,1.0
209765,0,6,0,0,6,0.0,1.0
59554,0,5,0,0,5,0.0,1.0
273336,0,5,0,0,5,0.0,1.0
123676,0,5,0,0,5,0.0,1.0
209684,0,7,0,0,7,0.0,1.0
59933,0,7,0,0,7,0.0,1.0
46892,0,18,0,0,18,0.0,1.0
1116,0,5,0,0,5,0.0,1.0
209059,0,5,0,0,5,0.0,1.0
58877,0,9,0,0,9,0.0,1.0
37168,0,7,0,0,7,0.0,1.0
77039,0,5,0,0,5,0.0,1.0
237407,0,6,0,0,6,0.0,1.0
174375,0,7,0,0,7,0.0,1.0
26782,0,6,0,0,6,0.0,1.0
107510,0,10,0,0,10,0.0,1.0
174195,0,8,0,0,8,0.0,1.0
91119,0,7,0,0,7,0.0,1.0
174151,0,13,0,0,13,0.0,1.0
155306,0,5,0,0,5,0.0,1.0
173773,0,9,0,0,9,0.0,1.0
172216,0,9,0,0,9,0.0,1.0
247840,0,11,0,0,11,0.0,1.0
156163,0,5,0,0,5,0.0,1.0
93105,0,5,0,0,5,0.0,1.0
259542,0,7,0,0,7,0.0,1.0
25009,0,6,0,0,6,0.0,1.0
15046,0,6,0,0,6,0.0,1.0
170850,0,5,0,0,5,0.0,1.0
94263,0,15,0,0,15,0.0,1.0
24391,0,6,0,0,6,0.0,1.0
249496,0,8,0,0,8,0.0,1.0
94396,0,6,0,0,6,0.0,1.0
169438,0,5,0,0,5,0.0,1.0
27204,0,5,0,0,5,0.0,1.0
260520,0,6,0,0,6,0.0,1.0
14461,0,5,0,0,5,0.0,1.0
175100,0,19,0,0,19,0.0,1.0
28735,0,7,0,0,7,0.0,1.0
152345,0,5,0,0,5,0.0,1.0
109107,0,6,0,0,6,0.0,1.0
152435,0,14,0,0,14,0.0,1.0
86641,0,5,0,0,5,0.0,1.0
177451,0,8,0,0,8,0.0,1.0
177262,0,5,0,0,5,0.0,1.0
88029,0,5,0,0,5,0.0,1.0
108563,0,7,0,0,7,0.0,1.0
153653,0,12,0,0,12,0.0,1.0
94997,0,5,0,0,5,0.0,1.0
176526,0,5,0,0,5,0.0,1.0
13666,0,6,0,0,6,0.0,1.0
88976,0,5,0,0,5,0.0,1.0
175463,0,5,0,0,5,0.0,1.0
261185,0,5,0,0,5,0.0,1.0
14180,0,7,0,0,7,0.0,1.0
246000,0,11,0,0,11,0.0,1.0
28091,0,6,0,0,6,0.0,1.0
108143,0,9,0,0,9,0.0,1.0
246230,0,5,0,0,5,0.0,1.0
154529,0,32,0,0,32,0.0,1.0
176256,0,8,0,0,8,0.0,1.0
28820,0,6,0,0,6,0.0,1.0
105476,0,8,0,0,8,0.0,1.0
250301,0,5,0,0,5,0.0,1.0
164675,0,22,0,0,22,0.0,1.0
160881,0,5,0,0,5,0.0,1.0
100361,0,11,0,0,11,0.0,1.0
100694,0,5,0,0,5,0.0,1.0
101041,0,6,0,0,6,0.0,1.0
17046,0,6,0,0,6,0.0,1.0
19760,0,5,0,0,5,0.0,1.0
253797,0,5,0,0,5,0.0,1.0
161234,0,12,0,0,12,0.0,1.0
163419,0,5,0,0,5,0.0,1.0
161265,0,9,0,0,9,0.0,1.0
254038,0,9,0,0,9,0.0,1.0
254196,0,8,0,0,8,0.0,1.0
254289,0,6,0,0,6,0.0,1.0
102581,0,7,0,0,7,0.0,1.0
18689,0,5,0,0,5,0.0,1.0
101517,0,5,0,0,5,0.0,1.0
161755,0,5,0,0,5,0.0,1.0
255786,0,9,0,0,9,0.0,1.0
254417,0,5,0,0,5,0.0,1.0
162610,0,5,0,0,5,0.0,1.0
16949,0,5,0,0,5,0.0,1.0
16877,0,7,0,0,7,0.0,1.0
99312,0,9,0,0,9,0.0,1.0
99146,0,6,0,0,6,0.0,1.0
15654,0,6,0,0,6,0.0,1.0
168985,0,6,0,0,6,0.0,1.0
157655,0,9,0,0,9,0.0,1.0
250733,0,9,0,0,9,0.0,1.0
251019,0,7,0,0,7,0.0,1.0
96771,0,7,0,0,7,0.0,1.0
158714,0,6,0,0,6,0.0,1.0
21930,0,5,0,0,5,0.0,1.0
251149,0,5,0,0,5,0.0,1.0
167038,0,5,0,0,5,0.0,1.0
169043,0,6,0,0,6,0.0,1.0
104925,0,10,0,0,10,0.0,1.0
98159,0,7,0,0,7,0.0,1.0
98575,0,6,0,0,6,0.0,1.0
251642,0,7,0,0,7,0.0,1.0
104604,0,9,0,0,9,0.0,1.0
98722,0,9,0,0,9,0.0,1.0
160154,0,7,0,0,7,0.0,1.0
98861,0,5,0,0,5,0.0,1.0
98887,0,11,0,0,11,0.0,1.0
98943,0,10,0,0,10,0.0,1.0
165267,0,7,0,0,7,0.0,1.0
166828,0,6,0,0,6,0.0,1.0
151846,0,5,0,0,5,0.0,1.0
178733,0,5,0,0,5,0.0,1.0
11944,0,8,0,0,8,0.0,1.0
77868,0,5,0,0,5,0.0,1.0
189655,0,5,0,0,5,0.0,1.0
34801,0,10,0,0,10,0.0,1.0
239486,0,5,0,0,5,0.0,1.0
189151,0,5,0,0,5,0.0,1.0
239834,0,5,0,0,5,0.0,1.0
188583,0,7,0,0,7,0.0,1.0
188518,0,6,0,0,6,0.0,1.0
187822,0,12,0,0,12,0.0,1.0
240541,0,5,0,0,5,0.0,1.0
146266,0,8,0,0,8,0.0,1.0
187761,0,7,0,0,7,0.0,1.0
80071,0,13,0,0,13,0.0,1.0
187170,0,5,0,0,5,0.0,1.0
146699,0,5,0,0,5,0.0,1.0
80234,0,6,0,0,6,0.0,1.0
186899,0,5,0,0,5,0.0,1.0
265827,0,6,0,0,6,0.0,1.0
186547,0,5,0,0,5,0.0,1.0
114007,0,12,0,0,12,0.0,1.0
241100,0,5,0,0,5,0.0,1.0
266678,0,8,0,0,8,0.0,1.0
189747,0,5,0,0,5,0.0,1.0
145003,0,6,0,0,6,0.0,1.0
144953,0,5,0,0,5,0.0,1.0
267529,0,6,0,0,6,0.0,1.0
75762,0,5,0,0,5,0.0,1.0
192914,0,6,0,0,6,0.0,1.0
6564,0,5,0,0,5,0.0,1.0
267442,0,5,0,0,5,0.0,1.0
36562,0,5,0,0,5,0.0,1.0
238010,0,6,0,0,6,0.0,1.0
76218,0,9,0,0,9,0.0,1.0
191188,0,9,0,0,9,0.0,1.0
36307,0,5,0,0,5,0.0,1.0
186527,0,12,0,0,12,0.0,1.0
36043,0,5,0,0,5,0.0,1.0
238639,0,5,0,0,5,0.0,1.0
35793,0,5,0,0,5,0.0,1.0
267061,0,7,0,0,7,0.0,1.0
77359,0,6,0,0,6,0.0,1.0
77517,0,6,0,0,6,0.0,1.0
239000,0,5,0,0,5,0.0,1.0
115998,0,7,0,0,7,0.0,1.0
239020,0,5,0,0,5,0.0,1.0
35532,0,5,0,0,5,0.0,1.0
189891,0,5,0,0,5,0.0,1.0
255544,0,7,0,0,7,0.0,1.0
241239,0,5,0,0,5,0.0,1.0
185677,0,16,0,0,16,0.0,1.0
32275,0,6,0,0,6,0.0,1.0
30531,0,6,0,0,6,0.0,1.0
10354,0,13,0,0,13,0.0,1.0
30461,0,7,0,0,7,0.0,1.0
111888,0,5,0,0,5,0.0,1.0
181452,0,7,0,0,7,0.0,1.0
263663,0,10,0,0,10,0.0,1.0
181436,0,7,0,0,7,0.0,1.0
84910,0,6,0,0,6,0.0,1.0
149843,0,11,0,0,11,0.0,1.0
180580,0,6,0,0,6,0.0,1.0
112109,0,6,0,0,6,0.0,1.0
85033,0,5,0,0,5,0.0,1.0
110700,0,7,0,0,7,0.0,1.0
85833,0,6,0,0,6,0.0,1.0
29539,0,5,0,0,5,0.0,1.0
179534,0,5,0,0,5,0.0,1.0
244452,0,10,0,0,10,0.0,1.0
244471,0,7,0,0,7,0.0,1.0
86123,0,8,0,0,8,0.0,1.0
178961,0,6,0,0,6,0.0,1.0
262634,0,8,0,0,8,0.0,1.0
11788,0,6,0,0,6,0.0,1.0
179857,0,12,0,0,12,0.0,1.0
193750,0,12,0,0,12,0.0,1.0
9454,0,5,0,0,5,0.0,1.0
112173,0,5,0,0,5,0.0,1.0
32188,0,10,0,0,10,0.0,1.0
241495,0,7,0,0,7,0.0,1.0
241527,0,7,0,0,7,0.0,1.0
185538,0,5,0,0,5,0.0,1.0
80954,0,5,0,0,5,0.0,1.0
80996,0,5,0,0,5,0.0,1.0
185011,0,10,0,0,10,0.0,1.0
184985,0,5,0,0,5,0.0,1.0
81121,0,21,0,0,21,0.0,1.0
81136,0,10,0,0,10,0.0,1.0
30594,0,13,0,0,13,0.0,1.0
184465,0,8,0,0,8,0.0,1.0
30906,0,5,0,0,5,0.0,1.0
264628,0,5,0,0,5,0.0,1.0
81927,0,5,0,0,5,0.0,1.0
82673,0,7,0,0,7,0.0,1.0
183187,0,17,0,0,17,0.0,1.0
9094,0,6,0,0,6,0.0,1.0
243004,0,6,0,0,6,0.0,1.0
112512,0,7,0,0,7,0.0,1.0
30838,0,6,0,0,6,0.0,1.0
148798,0,6,0,0,6,0.0,1.0
242639,0,16,0,0,16,0.0,1.0
128962,0,5,0,0,5,0.0,1.0
