,num_female,num_male,num_other,num_unknown,num_total,ratio_female,male_female_difference
10819,17,7,0,1,25,0.68,-0.4
36638,3,1,0,1,5,0.6,-0.4
36811,3,1,0,1,5,0.6,-0.4
227327,3,1,0,1,5,0.6,-0.4
125039,26,10,0,4,40,0.65,-0.4
140863,3,1,0,1,5,0.6,-0.4
98297,6,2,0,2,10,0.6,-0.4
26628,3,1,0,1,5,0.6,-0.4
237486,7,3,0,0,10,0.7,-0.4
166409,7,3,0,0,10,0.7,-0.4
218379,3,1,0,1,5,0.6,-0.4
112672,6,2,0,2,10,0.6,-0.4
260108,3,1,0,1,5,0.6,-0.4
153283,7,3,0,0,10,0.7,-0.4
183931,3,1,0,1,5,0.6,-0.4
196085,3,1,0,1,5,0.6,-0.4
64316,3,1,0,1,5,0.6,-0.4
49683,3,1,0,1,5,0.6,-0.4
45987,2,0,0,3,5,0.4,-0.4
10532,3,1,0,1,5,0.6,-0.4
10315,3,1,0,1,5,0.6,-0.4
252827,8,2,0,5,15,0.5333333333333333,-0.4
14744,7,3,0,0,10,0.7,-0.4
26713,7,3,0,0,10,0.7,-0.4
147385,3,1,0,1,5,0.6,-0.4
103336,18,7,0,3,28,0.6428571428571429,-0.39285714285714285
30273,13,4,0,6,23,0.5652173913043478,-0.391304347826087
53241,15,6,0,2,23,0.6521739130434783,-0.391304347826087
122793,38,15,0,6,59,0.6440677966101694,-0.3898305084745763
30487,37,16,0,1,54,0.6851851851851852,-0.3888888888888889
74758,10,3,0,5,18,0.5555555555555556,-0.3888888888888889
145619,12,5,0,1,18,0.6666666666666666,-0.3888888888888889
151589,9,4,0,0,13,0.6923076923076923,-0.38461538461538464
138777,9,4,0,0,13,0.6923076923076923,-0.38461538461538464
210317,9,4,0,0,13,0.6923076923076923,-0.38461538461538464
7082,9,4,0,0,13,0.6923076923076923,-0.38461538461538464
179733,9,4,0,0,13,0.6923076923076923,-0.38461538461538464
54453,9,4,0,0,13,0.6923076923076923,-0.38461538461538464
256507,8,3,0,2,13,0.6153846153846154,-0.38461538461538464
237064,9,4,0,0,13,0.6923076923076923,-0.38461538461538464
244736,9,4,0,0,13,0.6923076923076923,-0.38461538461538464
30555,9,4,0,0,13,0.6923076923076923,-0.38461538461538464
149120,9,4,0,0,13,0.6923076923076923,-0.38461538461538464
225887,9,4,0,0,13,0.6923076923076923,-0.38461538461538464
56804,14,6,0,1,21,0.6666666666666666,-0.38095238095238093
78783,46,19,0,6,71,0.647887323943662,-0.38028169014084506
203240,57,24,0,6,87,0.6551724137931034,-0.3793103448275862
144318,25,11,0,1,37,0.6756756756756757,-0.3783783783783784
238630,5,2,0,1,8,0.625,-0.375
16999,5,2,0,1,8,0.625,-0.375
219593,5,2,0,1,8,0.625,-0.375
50730,10,4,0,2,16,0.625,-0.375
217056,11,5,0,0,16,0.6875,-0.375
174503,4,1,0,3,8,0.5,-0.375
170493,5,2,0,1,8,0.625,-0.375
87712,21,9,0,2,32,0.65625,-0.375
240484,5,2,0,1,8,0.625,-0.375
99032,5,2,0,1,8,0.625,-0.375
173728,4,1,0,3,8,0.5,-0.375
167517,5,2,0,1,8,0.625,-0.375
144555,16,7,0,1,24,0.6666666666666666,-0.375
43006,11,5,0,0,16,0.6875,-0.375
160548,5,2,0,1,8,0.625,-0.375
79961,5,2,0,1,8,0.625,-0.375
19842,11,5,0,0,16,0.6875,-0.375
199178,5,2,0,1,8,0.625,-0.375
210261,5,2,0,1,8,0.625,-0.375
186807,3,0,0,5,8,0.375,-0.375
201923,5,2,0,1,8,0.625,-0.375
135873,5,2,0,1,8,0.625,-0.375
67677,5,2,0,1,8,0.625,-0.375
79747,5,2,0,1,8,0.625,-0.375
55787,5,2,0,1,8,0.625,-0.375
12123,5,2,0,1,8,0.625,-0.375
8734,10,4,0,2,16,0.625,-0.375
227447,42,18,0,4,64,0.65625,-0.375
31391,24,11,0,0,35,0.6857142857142857,-0.37142857142857144
254465,61,27,1,3,92,0.6630434782608695,-0.3695652173913043
26240,13,6,0,0,19,0.6842105263157895,-0.3684210526315789
24921,13,6,0,0,19,0.6842105263157895,-0.3684210526315789
52199,19,8,0,3,30,0.6333333333333333,-0.36666666666666664
251140,26,11,0,4,41,0.6341463414634146,-0.36585365853658536
209756,27,12,0,2,41,0.6585365853658537,-0.36585365853658536
274656,7,3,0,1,11,0.6363636363636364,-0.36363636363636365
248615,6,2,0,3,11,0.5454545454545454,-0.36363636363636365
152354,7,3,0,1,11,0.6363636363636364,-0.36363636363636365
77491,7,3,0,1,11,0.6363636363636364,-0.36363636363636365
161750,6,2,0,3,11,0.5454545454545454,-0.36363636363636365
92132,7,3,0,1,11,0.6363636363636364,-0.36363636363636365
114216,7,3,0,1,11,0.6363636363636364,-0.36363636363636365
123649,7,3,0,1,11,0.6363636363636364,-0.36363636363636365
36299,21,9,0,3,33,0.6363636363636364,-0.36363636363636365
199025,7,3,0,1,11,0.6363636363636364,-0.36363636363636365
86189,34,16,0,0,50,0.68,-0.36
236757,44,20,0,3,67,0.6567164179104478,-0.3582089552238806
61854,19,9,0,0,28,0.6785714285714286,-0.35714285714285715
167678,7,2,0,5,14,0.5,-0.35714285714285715
68256,9,4,0,1,14,0.6428571428571429,-0.35714285714285715
30052,9,4,0,1,14,0.6428571428571429,-0.35714285714285715
13582,19,9,0,0,28,0.6785714285714286,-0.35714285714285715
38464,8,3,0,3,14,0.5714285714285714,-0.35714285714285715
55927,19,9,0,0,28,0.6785714285714286,-0.35714285714285715
201641,9,4,0,1,14,0.6428571428571429,-0.35714285714285715
264031,48,22,0,3,73,0.6575342465753424,-0.3561643835616438
100846,31,14,0,3,48,0.6458333333333334,-0.3541666666666667
264862,11,5,0,1,17,0.6470588235294118,-0.35294117647058826
66073,11,5,0,1,17,0.6470588235294118,-0.35294117647058826
48743,11,5,0,1,17,0.6470588235294118,-0.35294117647058826
238699,11,5,0,1,17,0.6470588235294118,-0.35294117647058826
235282,63,27,0,12,102,0.6176470588235294,-0.35294117647058826
29526,35,16,0,3,54,0.6481481481481481,-0.35185185185185186
242143,13,6,0,1,20,0.65,-0.35
151139,13,6,0,1,20,0.65,-0.35
31393,29,14,0,0,43,0.6744186046511628,-0.3488372093023256
16966,14,6,0,3,23,0.6086956521739131,-0.34782608695652173
187065,17,8,0,1,26,0.6538461538461539,-0.34615384615384615
243236,19,9,0,1,29,0.6551724137931034,-0.3448275862068966
134797,29,14,0,1,44,0.6590909090909091,-0.3409090909090909
181687,33,16,0,1,50,0.66,-0.34
83671,35,17,0,1,53,0.660377358490566,-0.33962264150943394
193350,6,3,0,0,9,0.6666666666666666,-0.3333333333333333
245281,4,2,0,0,6,0.6666666666666666,-0.3333333333333333
149140,4,2,0,0,6,0.6666666666666666,-0.3333333333333333
120345,4,2,0,0,6,0.6666666666666666,-0.3333333333333333
138529,4,2,0,0,6,0.6666666666666666,-0.3333333333333333
142680,8,4,0,0,12,0.6666666666666666,-0.3333333333333333
112199,6,3,0,0,9,0.6666666666666666,-0.3333333333333333
131202,4,2,0,0,6,0.6666666666666666,-0.3333333333333333
112088,4,2,0,0,6,0.6666666666666666,-0.3333333333333333
141888,4,2,0,0,6,0.6666666666666666,-0.3333333333333333
194556,4,2,0,0,6,0.6666666666666666,-0.3333333333333333
65837,4,2,0,0,6,0.6666666666666666,-0.3333333333333333
110308,4,2,0,0,6,0.6666666666666666,-0.3333333333333333
26624,4,2,0,0,6,0.6666666666666666,-0.3333333333333333
74911,4,2,0,0,6,0.6666666666666666,-0.3333333333333333
123215,8,4,0,0,12,0.6666666666666666,-0.3333333333333333
129084,25,12,0,2,39,0.6410256410256411,-0.3333333333333333
27317,4,2,0,0,6,0.6666666666666666,-0.3333333333333333
13080,4,2,0,0,6,0.6666666666666666,-0.3333333333333333
119806,4,2,0,0,6,0.6666666666666666,-0.3333333333333333
255648,4,2,0,0,6,0.6666666666666666,-0.3333333333333333
245346,4,2,0,0,6,0.6666666666666666,-0.3333333333333333
204844,4,2,0,0,6,0.6666666666666666,-0.3333333333333333
16155,5,2,0,2,9,0.5555555555555556,-0.3333333333333333
13093,4,2,0,0,6,0.6666666666666666,-0.3333333333333333
28016,10,5,0,0,15,0.6666666666666666,-0.3333333333333333
141065,4,2,0,0,6,0.6666666666666666,-0.3333333333333333
204790,4,2,0,0,6,0.6666666666666666,-0.3333333333333333
34600,8,4,0,0,12,0.6666666666666666,-0.3333333333333333
141309,3,1,0,2,6,0.5,-0.3333333333333333
27193,4,2,0,0,6,0.6666666666666666,-0.3333333333333333
193482,4,2,0,0,6,0.6666666666666666,-0.3333333333333333
191841,4,2,0,0,6,0.6666666666666666,-0.3333333333333333
112541,12,6,0,0,18,0.6666666666666666,-0.3333333333333333
122542,4,2,0,0,6,0.6666666666666666,-0.3333333333333333
66533,4,2,0,0,6,0.6666666666666666,-0.3333333333333333
202346,4,2,0,0,6,0.6666666666666666,-0.3333333333333333
130502,4,2,0,0,6,0.6666666666666666,-0.3333333333333333
198726,8,4,0,0,12,0.6666666666666666,-0.3333333333333333
122418,4,2,0,0,6,0.6666666666666666,-0.3333333333333333
247855,4,2,0,0,6,0.6666666666666666,-0.3333333333333333
187801,6,3,0,0,9,0.6666666666666666,-0.3333333333333333
146345,6,3,0,0,9,0.6666666666666666,-0.3333333333333333
79958,4,2,0,0,6,0.6666666666666666,-0.3333333333333333
247966,4,2,0,0,6,0.6666666666666666,-0.3333333333333333
13551,6,3,0,0,9,0.6666666666666666,-0.3333333333333333
256844,6,3,0,0,9,0.6666666666666666,-0.3333333333333333
70402,8,4,0,0,12,0.6666666666666666,-0.3333333333333333
69790,4,2,0,0,6,0.6666666666666666,-0.3333333333333333
186848,4,2,0,0,6,0.6666666666666666,-0.3333333333333333
199041,14,7,0,0,21,0.6666666666666666,-0.3333333333333333
115120,9,4,0,2,15,0.6,-0.3333333333333333
201792,4,2,0,0,6,0.6666666666666666,-0.3333333333333333
115097,4,2,0,0,6,0.6666666666666666,-0.3333333333333333
31714,4,2,0,0,6,0.6666666666666666,-0.3333333333333333
114742,4,2,0,0,6,0.6666666666666666,-0.3333333333333333
31158,6,3,0,0,9,0.6666666666666666,-0.3333333333333333
248003,3,1,0,2,6,0.5,-0.3333333333333333
265784,6,3,0,0,9,0.6666666666666666,-0.3333333333333333
184789,8,4,0,0,12,0.6666666666666666,-0.3333333333333333
146207,6,3,0,0,9,0.6666666666666666,-0.3333333333333333
143011,4,2,0,0,6,0.6666666666666666,-0.3333333333333333
30645,4,2,0,0,6,0.6666666666666666,-0.3333333333333333
79172,3,1,0,2,6,0.5,-0.3333333333333333
204167,8,4,0,0,12,0.6666666666666666,-0.3333333333333333
244420,25,12,0,2,39,0.6410256410256411,-0.3333333333333333
29789,4,2,0,0,6,0.6666666666666666,-0.3333333333333333
77772,4,2,0,0,6,0.6666666666666666,-0.3333333333333333
183178,4,2,0,0,6,0.6666666666666666,-0.3333333333333333
122802,4,2,0,0,6,0.6666666666666666,-0.3333333333333333
81274,6,3,0,0,9,0.6666666666666666,-0.3333333333333333
113270,50,25,0,0,75,0.6666666666666666,-0.3333333333333333
77860,4,2,0,0,6,0.6666666666666666,-0.3333333333333333
113531,8,4,0,0,12,0.6666666666666666,-0.3333333333333333
189678,4,2,0,0,6,0.6666666666666666,-0.3333333333333333
115963,4,2,0,0,6,0.6666666666666666,-0.3333333333333333
278007,4,2,0,0,6,0.6666666666666666,-0.3333333333333333
143809,8,4,0,0,12,0.6666666666666666,-0.3333333333333333
71223,4,2,0,0,6,0.6666666666666666,-0.3333333333333333
25930,7,3,0,2,12,0.5833333333333334,-0.3333333333333333
32329,6,3,0,0,9,0.6666666666666666,-0.3333333333333333
243700,13,6,0,2,21,0.6190476190476191,-0.3333333333333333
78841,6,3,0,0,9,0.6666666666666666,-0.3333333333333333
70878,3,1,0,2,6,0.5,-0.3333333333333333
261327,5,2,0,2,9,0.5555555555555556,-0.3333333333333333
243584,4,2,0,0,6,0.6666666666666666,-0.3333333333333333
197939,5,2,0,2,9,0.5555555555555556,-0.3333333333333333
146855,6,3,0,0,9,0.6666666666666666,-0.3333333333333333
67198,16,8,0,0,24,0.6666666666666666,-0.3333333333333333
85256,4,2,0,0,6,0.6666666666666666,-0.3333333333333333
98958,6,3,0,0,9,0.6666666666666666,-0.3333333333333333
209631,8,4,0,0,12,0.6666666666666666,-0.3333333333333333
251518,6,3,0,0,9,0.6666666666666666,-0.3333333333333333
173225,4,2,0,0,6,0.6666666666666666,-0.3333333333333333
41450,3,1,0,2,6,0.5,-0.3333333333333333
162590,10,5,0,0,15,0.6666666666666666,-0.3333333333333333
159817,9,4,0,2,15,0.6,-0.3333333333333333
54283,4,2,0,0,6,0.6666666666666666,-0.3333333333333333
231395,4,2,0,0,6,0.6666666666666666,-0.3333333333333333
163433,6,3,0,0,9,0.6666666666666666,-0.3333333333333333
174072,10,5,0,0,15,0.6666666666666666,-0.3333333333333333
158033,6,3,0,0,9,0.6666666666666666,-0.3333333333333333
163443,4,2,0,0,6,0.6666666666666666,-0.3333333333333333
168500,4,2,0,0,6,0.6666666666666666,-0.3333333333333333
210874,11,5,0,2,18,0.6111111111111112,-0.3333333333333333
168387,8,4,0,0,12,0.6666666666666666,-0.3333333333333333
136291,4,2,0,0,6,0.6666666666666666,-0.3333333333333333
53590,9,4,0,2,15,0.6,-0.3333333333333333
90391,11,5,0,2,18,0.6111111111111112,-0.3333333333333333
264349,4,2,0,0,6,0.6666666666666666,-0.3333333333333333
156706,4,2,0,0,6,0.6666666666666666,-0.3333333333333333
272120,6,3,0,0,9,0.6666666666666666,-0.3333333333333333
232756,6,3,0,0,9,0.6666666666666666,-0.3333333333333333
249924,4,2,0,0,6,0.6666666666666666,-0.3333333333333333
219301,20,10,0,0,30,0.6666666666666666,-0.3333333333333333
19503,4,2,0,0,6,0.6666666666666666,-0.3333333333333333
39372,6,3,0,0,9,0.6666666666666666,-0.3333333333333333
175052,23,11,0,2,36,0.6388888888888888,-0.3333333333333333
44595,3,1,1,1,6,0.5,-0.3333333333333333
163612,8,4,0,0,12,0.6666666666666666,-0.3333333333333333
8937,8,4,0,0,12,0.6666666666666666,-0.3333333333333333
133557,4,2,0,0,6,0.6666666666666666,-0.3333333333333333
60040,4,2,0,0,6,0.6666666666666666,-0.3333333333333333
41757,9,4,0,2,15,0.6,-0.3333333333333333
230627,4,2,0,0,6,0.6666666666666666,-0.3333333333333333
20149,4,2,0,0,6,0.6666666666666666,-0.3333333333333333
20180,21,10,1,1,33,0.6363636363636364,-0.3333333333333333
135831,12,6,0,0,18,0.6666666666666666,-0.3333333333333333
102642,8,4,0,0,12,0.6666666666666666,-0.3333333333333333
170792,4,2,0,0,6,0.6666666666666666,-0.3333333333333333
55751,12,6,0,0,18,0.6666666666666666,-0.3333333333333333
268751,16,8,0,0,24,0.6666666666666666,-0.3333333333333333
215359,4,2,0,0,6,0.6666666666666666,-0.3333333333333333
20106,6,3,0,0,9,0.6666666666666666,-0.3333333333333333
161252,4,2,0,0,6,0.6666666666666666,-0.3333333333333333
20245,4,2,0,0,6,0.6666666666666666,-0.3333333333333333
215148,4,2,0,0,6,0.6666666666666666,-0.3333333333333333
9417,20,10,0,0,30,0.6666666666666666,-0.3333333333333333
43619,18,9,0,0,27,0.6666666666666666,-0.3333333333333333
228455,4,2,0,0,6,0.6666666666666666,-0.3333333333333333
259223,4,2,0,0,6,0.6666666666666666,-0.3333333333333333
11629,8,4,0,0,12,0.6666666666666666,-0.3333333333333333
103811,6,3,0,0,9,0.6666666666666666,-0.3333333333333333
205765,6,3,0,0,9,0.6666666666666666,-0.3333333333333333
170077,10,5,0,0,15,0.6666666666666666,-0.3333333333333333
229703,8,4,0,0,12,0.6666666666666666,-0.3333333333333333
42419,8,4,0,0,12,0.6666666666666666,-0.3333333333333333
57108,6,3,0,0,9,0.6666666666666666,-0.3333333333333333
250764,6,3,0,0,9,0.6666666666666666,-0.3333333333333333
160334,4,2,0,0,6,0.6666666666666666,-0.3333333333333333
227292,4,2,0,0,6,0.6666666666666666,-0.3333333333333333
230105,4,2,0,0,6,0.6666666666666666,-0.3333333333333333
104311,8,4,0,0,12,0.6666666666666666,-0.3333333333333333
57398,24,12,0,0,36,0.6666666666666666,-0.3333333333333333
253668,4,2,0,0,6,0.6666666666666666,-0.3333333333333333
100903,4,2,0,0,6,0.6666666666666666,-0.3333333333333333
253310,6,3,0,0,9,0.6666666666666666,-0.3333333333333333
24090,4,2,0,0,6,0.6666666666666666,-0.3333333333333333
100227,9,4,0,2,15,0.6,-0.3333333333333333
97694,9,4,0,2,15,0.6,-0.3333333333333333
208378,4,2,0,0,6,0.6666666666666666,-0.3333333333333333
236349,4,2,0,0,6,0.6666666666666666,-0.3333333333333333
268025,4,2,0,0,6,0.6666666666666666,-0.3333333333333333
164828,22,10,0,4,36,0.6111111111111112,-0.3333333333333333
221008,3,1,0,2,6,0.5,-0.3333333333333333
167587,10,5,0,0,15,0.6666666666666666,-0.3333333333333333
267802,4,2,0,0,6,0.6666666666666666,-0.3333333333333333
21462,4,2,0,0,6,0.6666666666666666,-0.3333333333333333
237715,4,2,0,0,6,0.6666666666666666,-0.3333333333333333
167478,6,3,0,0,9,0.6666666666666666,-0.3333333333333333
152409,10,5,0,0,15,0.6666666666666666,-0.3333333333333333
208936,4,2,0,0,6,0.6666666666666666,-0.3333333333333333
109516,4,2,0,0,6,0.6666666666666666,-0.3333333333333333
224479,4,2,0,0,6,0.6666666666666666,-0.3333333333333333
10241,4,2,0,0,6,0.6666666666666666,-0.3333333333333333
277959,3,1,0,2,6,0.5,-0.3333333333333333
86819,4,2,0,0,6,0.6666666666666666,-0.3333333333333333
178058,4,2,0,0,6,0.6666666666666666,-0.3333333333333333
48929,4,2,0,0,6,0.6666666666666666,-0.3333333333333333
269702,4,2,0,0,6,0.6666666666666666,-0.3333333333333333
63004,6,3,0,0,9,0.6666666666666666,-0.3333333333333333
125217,6,3,0,0,9,0.6666666666666666,-0.3333333333333333
154791,4,2,0,0,6,0.6666666666666666,-0.3333333333333333
127233,27,12,0,6,45,0.6,-0.3333333333333333
99026,6,3,0,0,9,0.6666666666666666,-0.3333333333333333
1660,4,2,0,0,6,0.6666666666666666,-0.3333333333333333
166030,4,2,0,0,6,0.6666666666666666,-0.3333333333333333
277195,6,3,0,0,9,0.6666666666666666,-0.3333333333333333
267621,4,2,0,0,6,0.6666666666666666,-0.3333333333333333
20484,4,2,0,0,6,0.6666666666666666,-0.3333333333333333
166327,4,2,0,0,6,0.6666666666666666,-0.3333333333333333
177237,4,2,0,0,6,0.6666666666666666,-0.3333333333333333
38034,7,3,0,2,12,0.5833333333333334,-0.3333333333333333
47127,4,2,0,0,6,0.6666666666666666,-0.3333333333333333
225191,5,2,0,2,9,0.5555555555555556,-0.3333333333333333
99204,4,2,0,0,6,0.6666666666666666,-0.3333333333333333
99252,4,2,0,0,6,0.6666666666666666,-0.3333333333333333
134863,4,2,0,0,6,0.6666666666666666,-0.3333333333333333
222506,4,2,0,0,6,0.6666666666666666,-0.3333333333333333
222492,4,2,0,0,6,0.6666666666666666,-0.3333333333333333
208415,7,3,0,2,12,0.5833333333333334,-0.3333333333333333
36554,9,4,0,2,15,0.6,-0.3333333333333333
255546,14,7,0,0,21,0.6666666666666666,-0.3333333333333333
96869,6,3,0,0,9,0.6666666666666666,-0.3333333333333333
224430,31,15,0,3,49,0.6326530612244898,-0.32653061224489793
88793,20,9,0,5,34,0.5882352941176471,-0.3235294117647059
69389,45,23,0,0,68,0.6617647058823529,-0.3235294117647059
12982,43,22,0,0,65,0.6615384615384615,-0.3230769230769231
228681,20,10,0,1,31,0.6451612903225806,-0.3225806451612903
95316,17,8,0,3,28,0.6071428571428571,-0.32142857142857145
246156,13,5,1,6,25,0.52,-0.32
248477,30,15,0,2,47,0.6382978723404256,-0.3191489361702128
39616,14,7,0,1,22,0.6363636363636364,-0.3181818181818182
223201,12,6,0,1,19,0.631578947368421,-0.3157894736842105
117251,22,11,0,2,35,0.6285714285714286,-0.3142857142857143
26593,10,5,0,1,16,0.625,-0.3125
131686,10,5,0,1,16,0.625,-0.3125
136382,43,22,0,3,68,0.6323529411764706,-0.3088235294117647
239594,39,19,0,7,65,0.6,-0.3076923076923077
38995,8,4,0,1,13,0.6153846153846154,-0.3076923076923077
17183,8,4,0,1,13,0.6153846153846154,-0.3076923076923077
260699,8,4,0,1,13,0.6153846153846154,-0.3076923076923077
208555,8,4,0,1,13,0.6153846153846154,-0.3076923076923077
249407,8,4,0,1,13,0.6153846153846154,-0.3076923076923077
183284,8,4,0,1,13,0.6153846153846154,-0.3076923076923077
278026,17,9,0,0,26,0.6538461538461539,-0.3076923076923077
231255,8,4,0,1,13,0.6153846153846154,-0.3076923076923077
262040,8,4,0,1,13,0.6153846153846154,-0.3076923076923077
104334,8,4,0,1,13,0.6153846153846154,-0.3076923076923077
102564,8,4,1,0,13,0.6153846153846154,-0.3076923076923077
170415,8,4,0,1,13,0.6153846153846154,-0.3076923076923077
196282,8,4,1,0,13,0.6153846153846154,-0.3076923076923077
224997,34,18,0,0,52,0.6538461538461539,-0.3076923076923077
85656,24,12,0,3,39,0.6153846153846154,-0.3076923076923077
138543,39,20,0,3,62,0.6290322580645161,-0.3064516129032258
55075,15,8,0,0,23,0.6521739130434783,-0.30434782608695654
259259,15,8,0,0,23,0.6521739130434783,-0.30434782608695654
178920,14,7,0,2,23,0.6086956521739131,-0.30434782608695654
190708,27,14,0,2,43,0.627906976744186,-0.3023255813953488
37556,6,3,0,1,10,0.6,-0.3
128045,6,3,0,1,10,0.6,-0.3
274466,6,3,0,1,10,0.6,-0.3
182993,36,18,0,6,60,0.6,-0.3
72352,6,3,0,1,10,0.6,-0.3
224927,6,3,0,1,10,0.6,-0.3
266807,6,3,0,1,10,0.6,-0.3
265083,6,3,0,1,10,0.6,-0.3
179433,19,10,0,1,30,0.6333333333333333,-0.3
95393,6,3,0,1,10,0.6,-0.3
11718,13,7,0,0,20,0.65,-0.3
112093,13,7,0,0,20,0.65,-0.3
31860,6,3,0,1,10,0.6,-0.3
161037,6,3,0,1,10,0.6,-0.3
43910,45,22,0,10,77,0.5844155844155844,-0.2987012987012987
73044,22,11,0,4,37,0.5945945945945946,-0.2972972972972973
135351,22,11,0,4,37,0.5945945945945946,-0.2972972972972973
168047,28,15,0,1,44,0.6363636363636364,-0.29545454545454547
12100,11,6,0,0,17,0.6470588235294118,-0.29411764705882354
21618,11,6,0,0,17,0.6470588235294118,-0.29411764705882354
32148,10,5,0,2,17,0.5882352941176471,-0.29411764705882354
98628,11,6,0,0,17,0.6470588235294118,-0.29411764705882354
21364,11,6,0,0,17,0.6470588235294118,-0.29411764705882354
170762,11,6,0,0,17,0.6470588235294118,-0.29411764705882354
238849,9,4,0,4,17,0.5294117647058824,-0.29411764705882354
31846,14,7,0,3,24,0.5833333333333334,-0.2916666666666667
278633,15,8,0,1,24,0.625,-0.2916666666666667
240568,18,7,0,13,38,0.47368421052631576,-0.2894736842105263
62862,27,14,0,4,45,0.6,-0.28888888888888886
207835,9,5,0,0,14,0.6428571428571429,-0.2857142857142857
235173,4,2,0,1,7,0.5714285714285714,-0.2857142857142857
96989,4,2,0,1,7,0.5714285714285714,-0.2857142857142857
194605,9,5,0,0,14,0.6428571428571429,-0.2857142857142857
260388,9,5,0,0,14,0.6428571428571429,-0.2857142857142857
164581,9,5,0,0,14,0.6428571428571429,-0.2857142857142857
505,4,2,0,1,7,0.5714285714285714,-0.2857142857142857
192093,13,7,0,1,21,0.6190476190476191,-0.2857142857142857
177295,9,5,0,0,14,0.6428571428571429,-0.2857142857142857
60797,4,2,0,1,7,0.5714285714285714,-0.2857142857142857
273071,4,2,0,1,7,0.5714285714285714,-0.2857142857142857
113364,4,2,0,1,7,0.5714285714285714,-0.2857142857142857
108485,8,4,0,2,14,0.5714285714285714,-0.2857142857142857
44389,4,2,0,1,7,0.5714285714285714,-0.2857142857142857
135768,4,2,0,1,7,0.5714285714285714,-0.2857142857142857
98525,4,2,0,1,7,0.5714285714285714,-0.2857142857142857
16721,4,2,0,1,7,0.5714285714285714,-0.2857142857142857
268761,4,2,0,1,7,0.5714285714285714,-0.2857142857142857
171638,12,6,0,3,21,0.5714285714285714,-0.2857142857142857
104058,9,5,0,0,14,0.6428571428571429,-0.2857142857142857
42651,4,2,0,1,7,0.5714285714285714,-0.2857142857142857
160378,4,2,0,1,7,0.5714285714285714,-0.2857142857142857
229768,13,7,0,1,21,0.6190476190476191,-0.2857142857142857
11400,9,5,0,0,14,0.6428571428571429,-0.2857142857142857
80690,4,2,0,1,7,0.5714285714285714,-0.2857142857142857
209265,4,2,0,1,7,0.5714285714285714,-0.2857142857142857
116549,4,2,0,1,7,0.5714285714285714,-0.2857142857142857
50129,9,5,0,0,14,0.6428571428571429,-0.2857142857142857
162626,4,2,0,1,7,0.5714285714285714,-0.2857142857142857
249223,9,5,0,0,14,0.6428571428571429,-0.2857142857142857
206675,9,5,0,0,14,0.6428571428571429,-0.2857142857142857
273318,4,2,0,1,7,0.5714285714285714,-0.2857142857142857
168216,8,4,0,2,14,0.5714285714285714,-0.2857142857142857
31446,4,2,0,1,7,0.5714285714285714,-0.2857142857142857
19570,4,2,0,1,7,0.5714285714285714,-0.2857142857142857
163467,4,2,0,1,7,0.5714285714285714,-0.2857142857142857
266109,4,2,0,1,7,0.5714285714285714,-0.2857142857142857
269890,26,14,0,2,42,0.6190476190476191,-0.2857142857142857
14422,40,22,0,2,64,0.625,-0.28125
183046,30,16,0,4,50,0.6,-0.28
48975,16,9,0,0,25,0.64,-0.28
223190,16,9,0,0,25,0.64,-0.28
138844,27,15,0,1,43,0.627906976744186,-0.27906976744186046
206305,23,13,0,0,36,0.6388888888888888,-0.2777777777777778
83646,10,5,0,3,18,0.5555555555555556,-0.2777777777777778
36609,20,9,0,11,40,0.5,-0.275
178130,7,4,0,0,11,0.6363636363636364,-0.2727272727272727
84897,7,4,0,0,11,0.6363636363636364,-0.2727272727272727
15670,6,3,0,2,11,0.5454545454545454,-0.2727272727272727
56661,7,4,0,0,11,0.6363636363636364,-0.2727272727272727
185147,7,4,0,0,11,0.6363636363636364,-0.2727272727272727
271705,40,22,0,4,66,0.6060606060606061,-0.2727272727272727
94529,7,4,0,0,11,0.6363636363636364,-0.2727272727272727
71900,7,4,0,0,11,0.6363636363636364,-0.2727272727272727
131032,7,4,0,0,11,0.6363636363636364,-0.2727272727272727
126812,7,4,0,0,11,0.6363636363636364,-0.2727272727272727
11916,7,4,0,0,11,0.6363636363636364,-0.2727272727272727
72238,7,4,0,0,11,0.6363636363636364,-0.2727272727272727
220664,7,4,0,0,11,0.6363636363636364,-0.2727272727272727
191165,7,4,0,0,11,0.6363636363636364,-0.2727272727272727
125060,7,4,0,0,11,0.6363636363636364,-0.2727272727272727
148662,7,4,0,0,11,0.6363636363636364,-0.2727272727272727
65791,7,4,0,0,11,0.6363636363636364,-0.2727272727272727
166825,6,3,0,2,11,0.5454545454545454,-0.2727272727272727
123515,7,4,0,0,11,0.6363636363636364,-0.2727272727272727
271448,55,31,0,3,89,0.6179775280898876,-0.2696629213483146
75860,9,5,0,1,15,0.6,-0.26666666666666666
124597,18,10,0,2,30,0.6,-0.26666666666666666
163488,18,10,0,2,30,0.6,-0.26666666666666666
204964,7,3,0,5,15,0.4666666666666667,-0.26666666666666666
22252,9,5,0,1,15,0.6,-0.26666666666666666
60583,9,5,0,1,15,0.6,-0.26666666666666666
251844,55,31,0,4,90,0.6111111111111112,-0.26666666666666666
204909,9,5,0,1,15,0.6,-0.26666666666666666
26883,17,8,0,9,34,0.5,-0.2647058823529412
264543,21,12,0,1,34,0.6176470588235294,-0.2647058823529412
194676,19,10,0,5,34,0.5588235294117647,-0.2647058823529412
56554,37,18,0,17,72,0.5138888888888888,-0.2638888888888889
49980,12,7,0,0,19,0.631578947368421,-0.2631578947368421
182202,12,7,0,0,19,0.631578947368421,-0.2631578947368421
205735,10,5,0,4,19,0.5263157894736842,-0.2631578947368421
174092,19,9,0,10,38,0.5,-0.2631578947368421
127359,38,21,0,6,65,0.5846153846153846,-0.26153846153846155
60621,14,8,0,1,23,0.6086956521739131,-0.2608695652173913
73330,14,8,0,1,23,0.6086956521739131,-0.2608695652173913
61038,17,10,0,0,27,0.6296296296296297,-0.25925925925925924
142579,16,9,0,2,27,0.5925925925925926,-0.25925925925925924
126693,21,12,0,2,35,0.6,-0.2571428571428571
30887,4,2,0,2,8,0.5,-0.25
182506,5,3,0,0,8,0.625,-0.25
240829,5,3,0,0,8,0.625,-0.25
206944,20,11,0,5,36,0.5555555555555556,-0.25
151043,5,3,0,0,8,0.625,-0.25
147839,12,7,0,1,20,0.6,-0.25
26084,5,3,0,0,8,0.625,-0.25
8870,5,3,0,0,8,0.625,-0.25
227591,5,3,0,0,8,0.625,-0.25
247829,5,3,0,0,8,0.625,-0.25
263321,5,3,0,0,8,0.625,-0.25
61211,5,3,0,0,8,0.625,-0.25
274199,7,4,0,1,12,0.5833333333333334,-0.25
162562,10,6,0,0,16,0.625,-0.25
33264,5,3,0,0,8,0.625,-0.25
148314,10,6,0,0,16,0.625,-0.25
249140,7,4,0,1,12,0.5833333333333334,-0.25
240113,5,3,0,0,8,0.625,-0.25
162780,10,6,0,0,16,0.625,-0.25
139828,14,8,0,2,24,0.5833333333333334,-0.25
231340,5,3,0,0,8,0.625,-0.25
140000,39,23,0,2,64,0.609375,-0.25
63865,5,3,0,0,8,0.625,-0.25
243745,5,3,0,0,8,0.625,-0.25
81015,4,2,0,2,8,0.5,-0.25
116123,5,3,0,0,8,0.625,-0.25
205285,5,3,0,0,8,0.625,-0.25
109135,5,3,0,0,8,0.625,-0.25
14374,5,3,0,0,8,0.625,-0.25
244676,4,2,0,2,8,0.5,-0.25
155000,5,3,0,0,8,0.625,-0.25
278554,5,3,0,0,8,0.625,-0.25
244708,5,3,0,0,8,0.625,-0.25
185671,5,3,0,0,8,0.625,-0.25
205145,5,3,0,0,8,0.625,-0.25
85554,5,3,0,0,8,0.625,-0.25
28448,4,2,0,2,8,0.5,-0.25
245328,5,3,0,0,8,0.625,-0.25
109899,10,6,0,0,16,0.625,-0.25
69749,4,2,0,2,8,0.5,-0.25
2012,5,3,0,0,8,0.625,-0.25
233431,5,3,0,0,8,0.625,-0.25
250330,12,7,0,1,20,0.6,-0.25
41634,5,3,0,0,8,0.625,-0.25
76818,19,11,0,2,32,0.59375,-0.25
194669,7,4,0,1,12,0.5833333333333334,-0.25
90075,5,3,0,0,8,0.625,-0.25
97587,5,3,0,0,8,0.625,-0.25
253311,5,3,0,0,8,0.625,-0.25
97423,5,3,0,0,8,0.625,-0.25
253556,6,3,0,3,12,0.5,-0.25
132901,5,3,0,0,8,0.625,-0.25
96448,20,12,0,0,32,0.625,-0.25
209464,7,4,0,1,12,0.5833333333333334,-0.25
211351,7,4,0,1,12,0.5833333333333334,-0.25
131974,5,3,0,0,8,0.625,-0.25
254201,15,9,0,0,24,0.625,-0.25
131837,10,6,0,0,16,0.625,-0.25
53605,5,3,0,0,8,0.625,-0.25
192185,5,3,0,0,8,0.625,-0.25
54605,5,3,0,0,8,0.625,-0.25
213851,5,3,0,0,8,0.625,-0.25
193499,31,18,0,3,52,0.5961538461538461,-0.25
221232,5,3,0,0,8,0.625,-0.25
59912,10,6,0,0,16,0.625,-0.25
111816,5,3,0,0,8,0.625,-0.25
99313,5,3,0,0,8,0.625,-0.25
48037,7,4,0,1,12,0.5833333333333334,-0.25
48217,10,6,0,0,16,0.625,-0.25
46909,29,17,0,2,48,0.6041666666666666,-0.25
239584,42,25,0,2,69,0.6086956521739131,-0.2463768115942029
27472,35,21,0,1,57,0.6140350877192983,-0.24561403508771928
178667,34,20,0,3,57,0.5964912280701754,-0.24561403508771928
142256,24,14,0,3,41,0.5853658536585366,-0.24390243902439024
206016,17,9,0,7,33,0.5151515151515151,-0.24242424242424243
26621,16,9,0,4,29,0.5517241379310345,-0.2413793103448276
131402,12,6,0,7,25,0.48,-0.24
76019,15,9,0,1,25,0.6,-0.24
125031,15,9,0,1,25,0.6,-0.24
226553,15,9,0,1,25,0.6,-0.24
60427,10,5,0,6,21,0.47619047619047616,-0.23809523809523808
110440,13,8,0,0,21,0.6190476190476191,-0.23809523809523808
148712,10,6,0,1,17,0.5882352941176471,-0.23529411764705882
159822,10,6,0,1,17,0.5882352941176471,-0.23529411764705882
66878,10,6,0,1,17,0.5882352941176471,-0.23529411764705882
29855,10,6,0,1,17,0.5882352941176471,-0.23529411764705882
73056,10,6,0,1,17,0.5882352941176471,-0.23529411764705882
56307,21,13,0,0,34,0.6176470588235294,-0.23529411764705882
238557,17,10,0,3,30,0.5666666666666667,-0.23333333333333334
274301,45,28,0,0,73,0.6164383561643836,-0.2328767123287671
1674,8,5,0,0,13,0.6153846153846154,-0.23076923076923078
266229,8,5,0,0,13,0.6153846153846154,-0.23076923076923078
100648,8,5,0,0,13,0.6153846153846154,-0.23076923076923078
64679,8,5,0,0,13,0.6153846153846154,-0.23076923076923078
147141,15,9,0,2,26,0.5769230769230769,-0.23076923076923078
135753,8,5,0,0,13,0.6153846153846154,-0.23076923076923078
188696,8,5,0,0,13,0.6153846153846154,-0.23076923076923078
63938,8,5,0,0,13,0.6153846153846154,-0.23076923076923078
255814,8,5,0,0,13,0.6153846153846154,-0.23076923076923078
189115,8,5,0,0,13,0.6153846153846154,-0.23076923076923078
183952,7,4,0,2,13,0.5384615384615384,-0.23076923076923078
22625,39,24,0,2,65,0.6,-0.23076923076923078
129465,8,5,0,0,13,0.6153846153846154,-0.23076923076923078
141710,23,14,0,2,39,0.5897435897435898,-0.23076923076923078
246513,22,13,0,4,39,0.5641025641025641,-0.23076923076923078
43687,16,10,0,0,26,0.6153846153846154,-0.23076923076923078
10314,25,15,0,4,44,0.5681818181818182,-0.22727272727272727
223087,24,14,0,6,44,0.5454545454545454,-0.22727272727272727
153950,13,8,0,1,22,0.5909090909090909,-0.22727272727272727
129008,11,7,0,0,18,0.6111111111111112,-0.2222222222222222
213410,5,3,0,1,9,0.5555555555555556,-0.2222222222222222
150327,5,3,0,1,9,0.5555555555555556,-0.2222222222222222
240131,5,3,0,1,9,0.5555555555555556,-0.2222222222222222
216882,5,3,0,1,9,0.5555555555555556,-0.2222222222222222
33933,11,7,0,0,18,0.6111111111111112,-0.2222222222222222
242073,10,6,0,2,18,0.5555555555555556,-0.2222222222222222
246959,5,3,0,1,9,0.5555555555555556,-0.2222222222222222
131099,4,2,0,3,9,0.4444444444444444,-0.2222222222222222
188038,5,3,0,1,9,0.5555555555555556,-0.2222222222222222
206891,5,3,0,1,9,0.5555555555555556,-0.2222222222222222
138647,5,3,0,1,9,0.5555555555555556,-0.2222222222222222
8680,5,3,0,1,9,0.5555555555555556,-0.2222222222222222
140255,5,3,0,1,9,0.5555555555555556,-0.2222222222222222
247240,16,10,0,1,27,0.5925925925925926,-0.2222222222222222
262407,5,3,0,1,9,0.5555555555555556,-0.2222222222222222
161299,11,7,0,0,18,0.6111111111111112,-0.2222222222222222
276165,16,10,0,1,27,0.5925925925925926,-0.2222222222222222
155147,16,10,0,1,27,0.5925925925925926,-0.2222222222222222
109741,5,3,0,1,9,0.5555555555555556,-0.2222222222222222
244710,5,3,0,1,9,0.5555555555555556,-0.2222222222222222
44728,10,6,0,2,18,0.5555555555555556,-0.2222222222222222
220759,5,3,0,1,9,0.5555555555555556,-0.2222222222222222
41395,5,3,0,1,9,0.5555555555555556,-0.2222222222222222
201447,15,9,0,3,27,0.5555555555555556,-0.2222222222222222
30770,5,3,0,1,9,0.5555555555555556,-0.2222222222222222
95506,10,6,0,2,18,0.5555555555555556,-0.2222222222222222
195904,16,10,0,1,27,0.5925925925925926,-0.2222222222222222
227025,10,6,0,2,18,0.5555555555555556,-0.2222222222222222
215988,23,14,0,4,41,0.5609756097560976,-0.21951219512195122
35857,32,20,0,3,55,0.5818181818181818,-0.21818181818181817
267510,14,9,0,0,23,0.6086956521739131,-0.21739130434782608
36135,14,9,0,0,23,0.6086956521739131,-0.21739130434782608
258482,14,9,0,0,23,0.6086956521739131,-0.21739130434782608
142745,13,8,0,2,23,0.5652173913043478,-0.21739130434782608
4017,47,29,0,8,84,0.5595238095238095,-0.21428571428571427
100393,8,5,0,1,14,0.5714285714285714,-0.21428571428571427
269439,6,3,0,5,14,0.42857142857142855,-0.21428571428571427
228311,8,5,0,1,14,0.5714285714285714,-0.21428571428571427
210822,8,5,0,1,14,0.5714285714285714,-0.21428571428571427
15602,17,11,0,0,28,0.6071428571428571,-0.21428571428571427
106331,8,5,0,1,14,0.5714285714285714,-0.21428571428571427
100459,35,22,0,4,61,0.5737704918032787,-0.21311475409836064
235935,35,22,1,3,61,0.5737704918032787,-0.21311475409836064
88229,11,7,0,1,19,0.5789473684210527,-0.21052631578947367
53456,11,7,0,1,19,0.5789473684210527,-0.21052631578947367
215006,11,7,0,1,19,0.5789473684210527,-0.21052631578947367
176214,14,9,0,1,24,0.5833333333333334,-0.20833333333333334
242409,12,7,0,5,24,0.5,-0.20833333333333334
157273,30,19,1,3,53,0.5660377358490566,-0.20754716981132076
133747,39,25,0,4,68,0.5735294117647058,-0.20588235294117646
276680,26,17,0,1,44,0.5909090909090909,-0.20454545454545456
10607,3,2,0,0,5,0.6,-0.2
252698,3,2,0,0,5,0.6,-0.2
50073,11,7,0,2,20,0.55,-0.2
269808,3,2,0,0,5,0.6,-0.2
165987,3,2,0,0,5,0.6,-0.2
50098,3,2,0,0,5,0.6,-0.2
50130,3,2,0,0,5,0.6,-0.2
252627,3,2,0,0,5,0.6,-0.2
133689,25,16,0,4,45,0.5555555555555556,-0.2
223402,3,2,0,0,5,0.6,-0.2
125216,6,4,0,0,10,0.6,-0.2
98647,6,4,0,0,10,0.6,-0.2
223238,3,2,0,0,5,0.6,-0.2
164906,3,2,0,0,5,0.6,-0.2
13094,3,2,0,0,5,0.6,-0.2
164775,3,2,0,0,5,0.6,-0.2
45471,3,2,0,0,5,0.6,-0.2
24379,3,2,0,0,5,0.6,-0.2
23619,3,2,0,0,5,0.6,-0.2
249848,3,2,0,0,5,0.6,-0.2
226267,6,4,0,0,10,0.6,-0.2
225683,3,2,0,0,5,0.6,-0.2
250506,3,2,0,0,5,0.6,-0.2
277873,2,1,0,2,5,0.4,-0.2
135411,6,4,0,0,10,0.6,-0.2
251527,3,2,0,0,5,0.6,-0.2
100610,3,2,0,0,5,0.6,-0.2
163796,3,2,0,0,5,0.6,-0.2
100460,3,2,0,0,5,0.6,-0.2
252282,3,2,0,0,5,0.6,-0.2
47594,3,2,0,0,5,0.6,-0.2
164027,5,3,0,2,10,0.5,-0.2
21049,3,2,0,0,5,0.6,-0.2
124993,3,2,0,0,5,0.6,-0.2
100004,3,2,0,0,5,0.6,-0.2
50972,3,2,0,0,5,0.6,-0.2
48382,2,1,0,2,5,0.4,-0.2
223977,3,2,0,0,5,0.6,-0.2
51071,3,2,0,0,5,0.6,-0.2
97848,3,2,0,0,5,0.6,-0.2
51082,2,1,0,2,5,0.4,-0.2
127417,3,2,0,0,5,0.6,-0.2
264204,3,2,0,0,5,0.6,-0.2
269378,6,4,0,0,10,0.6,-0.2
169282,2,1,0,2,5,0.4,-0.2
218640,3,2,0,0,5,0.6,-0.2
169492,3,2,0,0,5,0.6,-0.2
54374,3,2,0,0,5,0.6,-0.2
256843,20,13,0,2,35,0.5714285714285714,-0.2
93800,3,2,0,0,5,0.6,-0.2
53414,6,4,0,0,10,0.6,-0.2
93630,3,2,0,0,5,0.6,-0.2
127970,3,2,0,0,5,0.6,-0.2
16036,3,2,0,0,5,0.6,-0.2
93421,3,2,0,0,5,0.6,-0.2
216602,3,2,0,0,5,0.6,-0.2
55562,3,2,0,0,5,0.6,-0.2
128214,3,2,0,0,5,0.6,-0.2
171444,3,2,0,0,5,0.6,-0.2
55826,3,2,0,0,5,0.6,-0.2
258329,3,2,0,0,5,0.6,-0.2
9568,3,2,0,0,5,0.6,-0.2
255618,3,2,0,0,5,0.6,-0.2
126907,3,2,0,0,5,0.6,-0.2
53140,3,2,0,0,5,0.6,-0.2
269759,3,2,0,0,5,0.6,-0.2
3282,2,1,0,2,5,0.4,-0.2
252903,2,1,0,2,5,0.4,-0.2
126072,3,2,0,0,5,0.6,-0.2
166891,3,2,0,0,5,0.6,-0.2
221967,3,2,0,0,5,0.6,-0.2
126298,3,2,0,0,5,0.6,-0.2
96970,9,6,0,0,15,0.6,-0.2
221870,9,6,0,0,15,0.6,-0.2
167389,3,2,0,0,5,0.6,-0.2
269557,6,4,0,0,10,0.6,-0.2
52044,3,2,0,0,5,0.6,-0.2
10199,6,4,0,0,10,0.6,-0.2
96474,6,4,0,0,10,0.6,-0.2
132851,6,4,0,0,10,0.6,-0.2
20005,3,2,0,0,5,0.6,-0.2
221309,3,2,0,0,5,0.6,-0.2
132616,3,2,0,0,5,0.6,-0.2
221186,3,2,0,0,5,0.6,-0.2
96320,6,4,0,0,10,0.6,-0.2
276328,2,1,0,2,5,0.4,-0.2
276017,6,4,0,0,10,0.6,-0.2
275210,6,4,0,0,10,0.6,-0.2
25410,6,4,0,0,10,0.6,-0.2
226874,3,2,0,0,5,0.6,-0.2
13600,3,2,0,0,5,0.6,-0.2
12917,9,6,0,0,15,0.6,-0.2
1167,3,2,0,0,5,0.6,-0.2
31256,6,4,0,0,10,0.6,-0.2
236979,3,2,0,0,5,0.6,-0.2
273110,3,2,0,0,5,0.6,-0.2
31006,3,2,0,0,5,0.6,-0.2
153174,6,4,0,0,10,0.6,-0.2
37822,3,2,0,0,5,0.6,-0.2
115150,3,2,0,0,5,0.6,-0.2
273063,3,2,0,0,5,0.6,-0.2
1548,6,4,0,0,10,0.6,-0.2
262169,3,2,0,0,5,0.6,-0.2
30939,3,2,0,0,5,0.6,-0.2
154346,3,2,0,0,5,0.6,-0.2
154627,3,2,0,0,5,0.6,-0.2
38679,3,2,0,0,5,0.6,-0.2
154844,12,8,0,0,20,0.6,-0.2
38818,2,1,0,2,5,0.4,-0.2
242962,4,2,0,4,10,0.4,-0.2
115907,3,2,0,0,5,0.6,-0.2
109502,3,2,0,0,5,0.6,-0.2
151800,3,2,0,0,5,0.6,-0.2
114498,3,2,0,0,5,0.6,-0.2
214920,3,2,0,0,5,0.6,-0.2
33004,1,0,0,4,5,0.2,-0.2
150000,3,2,0,0,5,0.6,-0.2
32991,3,2,0,0,5,0.6,-0.2
111438,3,2,0,0,5,0.6,-0.2
709,3,2,0,0,5,0.6,-0.2
735,3,2,0,0,5,0.6,-0.2
113292,3,2,0,0,5,0.6,-0.2
239460,3,2,0,0,5,0.6,-0.2
32641,3,2,0,0,5,0.6,-0.2
240932,3,2,0,0,5,0.6,-0.2
38887,3,2,0,0,5,0.6,-0.2
238779,6,4,0,0,10,0.6,-0.2
241214,3,2,0,0,5,0.6,-0.2
274979,3,2,0,0,5,0.6,-0.2
273869,3,2,0,0,5,0.6,-0.2
151122,3,2,0,0,5,0.6,-0.2
32244,3,2,0,0,5,0.6,-0.2
35865,3,2,0,0,5,0.6,-0.2
35998,3,2,0,0,5,0.6,-0.2
32087,3,2,0,0,5,0.6,-0.2
241537,3,2,0,0,5,0.6,-0.2
114378,3,2,0,0,5,0.6,-0.2
12990,3,2,0,0,5,0.6,-0.2
270666,1,0,0,4,5,0.2,-0.2
30022,3,2,0,0,5,0.6,-0.2
117553,3,2,0,0,5,0.6,-0.2
138867,3,2,0,0,5,0.6,-0.2
138826,3,2,0,0,5,0.6,-0.2
26611,3,2,0,0,5,0.6,-0.2
229767,3,2,0,0,5,0.6,-0.2
229656,3,2,0,0,5,0.6,-0.2
229454,3,2,0,0,5,0.6,-0.2
26521,3,2,0,0,5,0.6,-0.2
43698,3,2,0,0,5,0.6,-0.2
26374,3,2,0,0,5,0.6,-0.2
193448,3,2,0,0,5,0.6,-0.2
121594,6,4,0,0,10,0.6,-0.2
102676,3,2,0,0,5,0.6,-0.2
121817,9,6,0,0,15,0.6,-0.2
44535,6,4,0,0,10,0.6,-0.2
247852,15,9,0,6,30,0.5,-0.2
44743,3,2,0,0,5,0.6,-0.2
11621,3,2,0,0,5,0.6,-0.2
102284,3,2,0,0,5,0.6,-0.2
138193,3,2,0,0,5,0.6,-0.2
34501,3,2,0,0,5,0.6,-0.2
122643,3,2,0,0,5,0.6,-0.2
41245,3,2,0,0,5,0.6,-0.2
104796,3,2,0,0,5,0.6,-0.2
120610,4,2,0,4,10,0.4,-0.2
275111,6,4,0,0,10,0.6,-0.2
107099,3,2,0,0,5,0.6,-0.2
28709,3,2,0,0,5,0.6,-0.2
233430,6,4,0,0,10,0.6,-0.2
233427,3,2,0,0,5,0.6,-0.2
245203,3,2,0,0,5,0.6,-0.2
233312,3,2,0,0,5,0.6,-0.2
106846,3,2,0,0,5,0.6,-0.2
39374,3,2,0,0,5,0.6,-0.2
28360,3,2,0,0,5,0.6,-0.2
245814,3,2,0,0,5,0.6,-0.2
38991,3,2,0,0,5,0.6,-0.2
232343,3,2,0,0,5,0.6,-0.2
246175,2,1,0,2,5,0.4,-0.2
232030,3,2,0,0,5,0.6,-0.2
140451,3,2,0,0,5,0.6,-0.2
40466,3,2,0,0,5,0.6,-0.2
105317,3,2,0,0,5,0.6,-0.2
119858,5,3,0,2,10,0.5,-0.2
27684,3,2,0,0,5,0.6,-0.2
41058,3,2,0,0,5,0.6,-0.2
159647,3,2,0,0,5,0.6,-0.2
27573,1,0,0,4,5,0.2,-0.2
27956,3,2,0,0,5,0.6,-0.2
36568,3,2,0,0,5,0.6,-0.2
7860,3,2,0,0,5,0.6,-0.2
81263,14,9,0,2,25,0.56,-0.2
5741,3,2,0,0,5,0.6,-0.2
9343,3,2,0,0,5,0.6,-0.2
87948,3,2,0,0,5,0.6,-0.2
82901,3,2,0,0,5,0.6,-0.2
80810,24,16,0,0,40,0.6,-0.2
83110,3,2,0,0,5,0.6,-0.2
190533,3,2,0,0,5,0.6,-0.2
91263,3,2,0,0,5,0.6,-0.2
76976,2,1,0,2,5,0.4,-0.2
212697,2,1,0,2,5,0.4,-0.2
194606,3,2,0,0,5,0.6,-0.2
73795,3,2,0,0,5,0.6,-0.2
83443,15,10,0,0,25,0.6,-0.2
60140,3,2,0,0,5,0.6,-0.2
74093,3,2,0,0,5,0.6,-0.2
65487,3,2,0,0,5,0.6,-0.2
73363,3,2,0,0,5,0.6,-0.2
267256,3,2,0,0,5,0.6,-0.2
77960,3,2,0,0,5,0.6,-0.2
200213,3,2,0,0,5,0.6,-0.2
89945,3,2,0,0,5,0.6,-0.2
81771,11,7,0,2,20,0.55,-0.2
203058,3,2,0,0,5,0.6,-0.2
61619,3,2,0,0,5,0.6,-0.2
67288,6,4,0,0,10,0.6,-0.2
268639,3,2,0,0,5,0.6,-0.2
9226,3,2,0,0,5,0.6,-0.2
207350,3,2,0,0,5,0.6,-0.2
89851,6,4,0,0,10,0.6,-0.2
90915,3,2,0,0,5,0.6,-0.2
78471,3,2,0,0,5,0.6,-0.2
6679,3,2,0,0,5,0.6,-0.2
203506,6,4,0,0,10,0.6,-0.2
204448,2,1,0,2,5,0.4,-0.2
175529,6,4,0,0,10,0.6,-0.2
189235,3,2,0,0,5,0.6,-0.2
78545,3,2,0,0,5,0.6,-0.2
60278,3,2,0,0,5,0.6,-0.2
182414,3,2,0,0,5,0.6,-0.2
7809,3,2,0,0,5,0.6,-0.2
60703,3,2,0,0,5,0.6,-0.2
7890,2,1,0,2,5,0.4,-0.2
201521,3,2,0,0,5,0.6,-0.2
201568,3,2,0,0,5,0.6,-0.2
60307,6,4,0,0,10,0.6,-0.2
266697,3,2,0,0,5,0.6,-0.2
74328,3,2,0,0,5,0.6,-0.2
213150,20,13,0,2,35,0.5714285714285714,-0.2
194205,3,2,0,0,5,0.6,-0.2
172374,3,2,0,0,5,0.6,-0.2
63923,3,2,0,0,5,0.6,-0.2
193966,3,2,0,0,5,0.6,-0.2
181223,6,4,0,0,10,0.6,-0.2
60412,3,2,0,0,5,0.6,-0.2
266419,3,2,0,0,5,0.6,-0.2
179906,3,2,0,0,5,0.6,-0.2
201725,3,2,0,0,5,0.6,-0.2
84795,21,14,0,1,36,0.5833333333333334,-0.19444444444444445
143253,17,11,0,3,31,0.5483870967741935,-0.1935483870967742
146230,18,12,0,1,31,0.5806451612903226,-0.1935483870967742
171818,11,7,0,3,21,0.5238095238095238,-0.19047619047619047
260897,25,17,0,0,42,0.5952380952380952,-0.19047619047619047
33974,12,8,0,1,21,0.5714285714285714,-0.19047619047619047
76483,12,8,0,1,21,0.5714285714285714,-0.19047619047619047
148898,12,8,0,1,21,0.5714285714285714,-0.19047619047619047
69405,12,8,0,1,21,0.5714285714285714,-0.19047619047619047
88620,8,5,0,3,16,0.5,-0.1875
156214,19,13,0,0,32,0.59375,-0.1875
6323,16,11,0,0,27,0.5925925925925926,-0.18518518518518517
261314,6,4,0,1,11,0.5454545454545454,-0.18181818181818182
152309,6,4,0,1,11,0.5454545454545454,-0.18181818181818182
154975,6,4,0,1,11,0.5454545454545454,-0.18181818181818182
216466,19,13,0,1,33,0.5757575757575758,-0.18181818181818182
103304,6,4,0,1,11,0.5454545454545454,-0.18181818181818182
223210,6,4,0,1,11,0.5454545454545454,-0.18181818181818182
240267,6,4,0,1,11,0.5454545454545454,-0.18181818181818182
138176,6,4,0,1,11,0.5454545454545454,-0.18181818181818182
208605,6,4,0,1,11,0.5454545454545454,-0.18181818181818182
86720,12,8,0,2,22,0.5454545454545454,-0.18181818181818182
192479,6,4,0,1,11,0.5454545454545454,-0.18181818181818182
44842,6,4,0,1,11,0.5454545454545454,-0.18181818181818182
126810,6,4,0,1,11,0.5454545454545454,-0.18181818181818182
244277,13,9,0,0,22,0.5909090909090909,-0.18181818181818182
125203,13,9,0,0,22,0.5909090909090909,-0.18181818181818182
234925,6,4,0,1,11,0.5454545454545454,-0.18181818181818182
184424,26,18,0,0,44,0.5909090909090909,-0.18181818181818182
7286,6,4,0,1,11,0.5454545454545454,-0.18181818181818182
169249,6,4,0,1,11,0.5454545454545454,-0.18181818181818182
20336,6,4,0,1,11,0.5454545454545454,-0.18181818181818182
2033,28,19,1,2,50,0.56,-0.18
160819,21,14,0,4,39,0.5384615384615384,-0.1794871794871795
229551,20,13,0,6,39,0.5128205128205128,-0.1794871794871795
142479,16,11,0,1,28,0.5714285714285714,-0.17857142857142858
166123,32,22,0,2,56,0.5714285714285714,-0.17857142857142858
51992,16,11,0,1,28,0.5714285714285714,-0.17857142857142858
24433,15,10,0,3,28,0.5357142857142857,-0.17857142857142858
145737,8,5,0,4,17,0.47058823529411764,-0.17647058823529413
163307,10,7,0,0,17,0.5882352941176471,-0.17647058823529413
210717,9,6,0,2,17,0.5294117647058824,-0.17647058823529413
20462,10,7,0,0,17,0.5882352941176471,-0.17647058823529413
148804,10,7,0,0,17,0.5882352941176471,-0.17647058823529413
230708,7,4,0,6,17,0.4117647058823529,-0.17647058823529413
70183,13,9,0,1,23,0.5652173913043478,-0.17391304347826086
184513,26,18,0,2,46,0.5652173913043478,-0.17391304347826086
169699,12,8,0,3,23,0.5217391304347826,-0.17391304347826086
37712,56,39,0,3,98,0.5714285714285714,-0.17346938775510204
21011,16,11,0,2,29,0.5517241379310345,-0.1724137931034483
267033,20,14,0,1,35,0.5714285714285714,-0.17142857142857143
263163,26,18,0,3,47,0.5531914893617021,-0.1702127659574468
244359,7,5,0,0,12,0.5833333333333334,-0.16666666666666666
226745,3,2,0,1,6,0.5,-0.16666666666666666
225912,6,4,0,2,12,0.5,-0.16666666666666666
208367,3,2,0,1,6,0.5,-0.16666666666666666
59390,7,5,0,0,12,0.5833333333333334,-0.16666666666666666
261567,3,2,0,1,6,0.5,-0.16666666666666666
115572,24,17,0,1,42,0.5714285714285714,-0.16666666666666666
139742,16,11,0,3,30,0.5333333333333333,-0.16666666666666666
101081,3,2,0,1,6,0.5,-0.16666666666666666
187029,3,2,0,1,6,0.5,-0.16666666666666666
61146,3,2,0,1,6,0.5,-0.16666666666666666
226554,2,1,0,3,6,0.3333333333333333,-0.16666666666666666
98356,10,7,0,1,18,0.5555555555555556,-0.16666666666666666
32195,10,7,0,1,18,0.5555555555555556,-0.16666666666666666
224435,3,2,0,1,6,0.5,-0.16666666666666666
179772,10,7,0,1,18,0.5555555555555556,-0.16666666666666666
100782,5,3,0,4,12,0.4166666666666667,-0.16666666666666666
144828,7,5,0,0,12,0.5833333333333334,-0.16666666666666666
119590,10,7,0,1,18,0.5555555555555556,-0.16666666666666666
146874,3,2,0,1,6,0.5,-0.16666666666666666
28076,3,2,0,1,6,0.5,-0.16666666666666666
224122,3,2,0,1,6,0.5,-0.16666666666666666
146057,6,3,0,9,18,0.3333333333333333,-0.16666666666666666
10946,3,2,0,1,6,0.5,-0.16666666666666666
223454,3,2,0,1,6,0.5,-0.16666666666666666
27812,10,7,0,1,18,0.5555555555555556,-0.16666666666666666
101620,14,10,0,0,24,0.5833333333333334,-0.16666666666666666
176459,7,5,0,0,12,0.5833333333333334,-0.16666666666666666
148929,3,2,0,1,6,0.5,-0.16666666666666666
41911,7,5,0,0,12,0.5833333333333334,-0.16666666666666666
231993,7,5,0,0,12,0.5833333333333334,-0.16666666666666666
131027,10,7,0,1,18,0.5555555555555556,-0.16666666666666666
159854,3,2,0,1,6,0.5,-0.16666666666666666
72100,7,5,0,0,12,0.5833333333333334,-0.16666666666666666
87401,3,2,0,1,6,0.5,-0.16666666666666666
2139,3,2,0,1,6,0.5,-0.16666666666666666
204619,3,2,0,1,6,0.5,-0.16666666666666666
219008,3,2,0,1,6,0.5,-0.16666666666666666
35909,3,2,0,1,6,0.5,-0.16666666666666666
157127,3,2,0,1,6,0.5,-0.16666666666666666
159137,3,2,0,1,6,0.5,-0.16666666666666666
110214,7,5,0,0,12,0.5833333333333334,-0.16666666666666666
41123,3,2,0,1,6,0.5,-0.16666666666666666
6611,7,5,0,0,12,0.5833333333333334,-0.16666666666666666
36801,3,2,0,1,6,0.5,-0.16666666666666666
132199,7,5,0,0,12,0.5833333333333334,-0.16666666666666666
17596,1,0,0,5,6,0.16666666666666666,-0.16666666666666666
15945,3,2,0,1,6,0.5,-0.16666666666666666
57833,2,1,0,3,6,0.3333333333333333,-0.16666666666666666
37147,3,2,0,1,6,0.5,-0.16666666666666666
54911,3,2,0,1,6,0.5,-0.16666666666666666
169403,3,2,0,1,6,0.5,-0.16666666666666666
180925,3,2,0,1,6,0.5,-0.16666666666666666
71786,7,5,0,0,12,0.5833333333333334,-0.16666666666666666
66485,1,0,0,5,6,0.16666666666666666,-0.16666666666666666
155444,7,5,0,0,12,0.5833333333333334,-0.16666666666666666
222501,3,2,0,1,6,0.5,-0.16666666666666666
233436,3,2,0,1,6,0.5,-0.16666666666666666
8529,3,2,0,1,6,0.5,-0.16666666666666666
222296,31,22,0,1,54,0.5740740740740741,-0.16666666666666666
222220,14,10,0,0,24,0.5833333333333334,-0.16666666666666666
188106,3,2,0,1,6,0.5,-0.16666666666666666
25827,7,5,0,0,12,0.5833333333333334,-0.16666666666666666
128331,7,5,0,0,12,0.5833333333333334,-0.16666666666666666
183436,3,2,0,1,6,0.5,-0.16666666666666666
11657,7,5,0,0,12,0.5833333333333334,-0.16666666666666666
205538,3,2,0,1,6,0.5,-0.16666666666666666
33862,7,5,0,0,12,0.5833333333333334,-0.16666666666666666
259430,6,4,0,2,12,0.5,-0.16666666666666666
137190,7,4,0,7,18,0.3888888888888889,-0.16666666666666666
259388,3,2,0,1,6,0.5,-0.16666666666666666
23659,3,2,0,1,6,0.5,-0.16666666666666666
16818,3,2,0,1,6,0.5,-0.16666666666666666
167611,2,1,0,3,6,0.3333333333333333,-0.16666666666666666
250368,7,5,0,0,12,0.5833333333333334,-0.16666666666666666
275264,3,2,0,1,6,0.5,-0.16666666666666666
128119,14,10,0,0,24,0.5833333333333334,-0.16666666666666666
264284,3,2,0,1,6,0.5,-0.16666666666666666
205473,15,10,3,3,31,0.4838709677419355,-0.16129032258064516
252071,16,11,0,4,31,0.5161290322580645,-0.16129032258064516
229409,18,13,0,0,31,0.5806451612903226,-0.16129032258064516
241980,61,44,0,1,106,0.5754716981132075,-0.16037735849056603
130571,41,29,0,5,75,0.5466666666666666,-0.16
268110,40,28,0,7,75,0.5333333333333333,-0.16
266056,42,30,0,3,75,0.56,-0.16
50895,29,21,0,0,50,0.58,-0.16
79740,14,10,0,1,25,0.56,-0.16
65877,9,6,0,4,19,0.47368421052631576,-0.15789473684210525
80555,11,8,0,0,19,0.5789473684210527,-0.15789473684210525
78015,11,8,0,0,19,0.5789473684210527,-0.15789473684210525
271460,11,8,0,0,19,0.5789473684210527,-0.15789473684210525
36817,10,7,0,2,19,0.5263157894736842,-0.15789473684210525
135458,18,13,0,1,32,0.5625,-0.15625
188010,17,12,0,3,32,0.53125,-0.15625
228868,7,5,0,1,13,0.5384615384615384,-0.15384615384615385
227097,7,5,0,1,13,0.5384615384615384,-0.15384615384615385
205843,5,3,0,5,13,0.38461538461538464,-0.15384615384615385
91130,7,5,0,1,13,0.5384615384615384,-0.15384615384615385
55858,7,5,0,1,13,0.5384615384615384,-0.15384615384615385
70703,6,4,0,3,13,0.46153846153846156,-0.15384615384615385
139243,7,5,0,1,13,0.5384615384615384,-0.15384615384615385
269157,7,5,0,1,13,0.5384615384615384,-0.15384615384615385
196077,43,30,0,12,85,0.5058823529411764,-0.15294117647058825
91058,11,8,0,1,20,0.55,-0.15
223154,27,20,0,0,47,0.574468085106383,-0.14893617021276595
231237,29,21,1,3,54,0.5370370370370371,-0.14814814814814814
102967,30,22,0,2,54,0.5555555555555556,-0.14814814814814814
206074,15,11,0,1,27,0.5555555555555556,-0.14814814814814814
187256,42,31,0,2,75,0.56,-0.14666666666666667
251394,22,16,1,2,41,0.5365853658536586,-0.14634146341463414
130961,4,3,0,0,7,0.5714285714285714,-0.14285714285714285
169600,4,3,0,0,7,0.5714285714285714,-0.14285714285714285
268691,4,3,0,0,7,0.5714285714285714,-0.14285714285714285
173951,4,3,0,0,7,0.5714285714285714,-0.14285714285714285
91449,4,3,0,0,7,0.5714285714285714,-0.14285714285714285
193612,4,3,0,0,7,0.5714285714285714,-0.14285714285714285
83166,4,3,0,0,7,0.5714285714285714,-0.14285714285714285
77261,4,3,0,0,7,0.5714285714285714,-0.14285714285714285
35845,4,3,0,0,7,0.5714285714285714,-0.14285714285714285
169057,8,6,0,0,14,0.5714285714285714,-0.14285714285714285
190459,8,6,0,0,14,0.5714285714285714,-0.14285714285714285
239374,4,3,0,0,7,0.5714285714285714,-0.14285714285714285
66443,7,5,0,2,14,0.5,-0.14285714285714285
107324,4,3,0,0,7,0.5714285714285714,-0.14285714285714285
125287,8,6,0,0,14,0.5714285714285714,-0.14285714285714285
251843,39,29,0,2,70,0.5571428571428572,-0.14285714285714285
21875,4,3,0,0,7,0.5714285714285714,-0.14285714285714285
271503,4,3,0,0,7,0.5714285714285714,-0.14285714285714285
230629,4,3,0,0,7,0.5714285714285714,-0.14285714285714285
129373,4,3,0,0,7,0.5714285714285714,-0.14285714285714285
91165,4,3,0,0,7,0.5714285714285714,-0.14285714285714285
124175,4,3,0,0,7,0.5714285714285714,-0.14285714285714285
86555,4,3,0,0,7,0.5714285714285714,-0.14285714285714285
6537,4,3,0,0,7,0.5714285714285714,-0.14285714285714285
82831,8,5,0,8,21,0.38095238095238093,-0.14285714285714285
72785,4,3,0,0,7,0.5714285714285714,-0.14285714285714285
11832,4,3,0,0,7,0.5714285714285714,-0.14285714285714285
83306,4,3,0,0,7,0.5714285714285714,-0.14285714285714285
238540,4,3,0,0,7,0.5714285714285714,-0.14285714285714285
256603,4,3,0,0,7,0.5714285714285714,-0.14285714285714285
216724,4,3,0,0,7,0.5714285714285714,-0.14285714285714285
156837,2,1,0,4,7,0.2857142857142857,-0.14285714285714285
170742,3,2,0,2,7,0.42857142857142855,-0.14285714285714285
17970,4,3,0,0,7,0.5714285714285714,-0.14285714285714285
6563,27,20,0,2,49,0.5510204081632653,-0.14285714285714285
131317,4,3,0,0,7,0.5714285714285714,-0.14285714285714285
269140,4,3,0,0,7,0.5714285714285714,-0.14285714285714285
65145,4,3,0,0,7,0.5714285714285714,-0.14285714285714285
131597,4,3,0,0,7,0.5714285714285714,-0.14285714285714285
179288,7,5,0,2,14,0.5,-0.14285714285714285
157163,8,6,0,0,14,0.5714285714285714,-0.14285714285714285
18384,4,3,0,0,7,0.5714285714285714,-0.14285714285714285
109084,4,3,0,0,7,0.5714285714285714,-0.14285714285714285
83775,4,3,0,0,7,0.5714285714285714,-0.14285714285714285
180860,4,3,0,0,7,0.5714285714285714,-0.14285714285714285
109357,4,3,0,0,7,0.5714285714285714,-0.14285714285714285
130792,4,3,0,0,7,0.5714285714285714,-0.14285714285714285
217958,4,3,0,0,7,0.5714285714285714,-0.14285714285714285
204946,4,3,0,0,7,0.5714285714285714,-0.14285714285714285
170184,7,5,0,2,14,0.5,-0.14285714285714285
184629,7,5,0,2,14,0.5,-0.14285714285714285
94334,4,3,0,0,7,0.5714285714285714,-0.14285714285714285
253626,4,3,0,0,7,0.5714285714285714,-0.14285714285714285
7915,19,14,0,2,35,0.5428571428571428,-0.14285714285714285
93147,4,3,0,0,7,0.5714285714285714,-0.14285714285714285
267356,4,3,0,0,7,0.5714285714285714,-0.14285714285714285
163676,4,3,0,0,7,0.5714285714285714,-0.14285714285714285
220867,2,1,0,4,7,0.2857142857142857,-0.14285714285714285
45064,3,2,0,2,7,0.42857142857142855,-0.14285714285714285
268618,4,3,0,0,7,0.5714285714285714,-0.14285714285714285
34526,3,2,0,2,7,0.42857142857142855,-0.14285714285714285
98574,4,3,0,0,7,0.5714285714285714,-0.14285714285714285
81492,21,15,0,6,42,0.5,-0.14285714285714285
102129,4,3,0,0,7,0.5714285714285714,-0.14285714285714285
187747,4,3,0,0,7,0.5714285714285714,-0.14285714285714285
59820,4,3,0,0,7,0.5714285714285714,-0.14285714285714285
278221,4,3,0,0,7,0.5714285714285714,-0.14285714285714285
13518,8,6,0,0,14,0.5714285714285714,-0.14285714285714285
165576,4,3,0,0,7,0.5714285714285714,-0.14285714285714285
28096,4,3,0,0,7,0.5714285714285714,-0.14285714285714285
265972,4,3,0,0,7,0.5714285714285714,-0.14285714285714285
99222,4,3,0,0,7,0.5714285714285714,-0.14285714285714285
263877,16,12,0,0,28,0.5714285714285714,-0.14285714285714285
223892,4,3,0,0,7,0.5714285714285714,-0.14285714285714285
6789,4,3,0,0,7,0.5714285714285714,-0.14285714285714285
81324,4,3,0,0,7,0.5714285714285714,-0.14285714285714285
117318,4,3,0,0,7,0.5714285714285714,-0.14285714285714285
49061,4,3,0,0,7,0.5714285714285714,-0.14285714285714285
244484,4,3,0,0,7,0.5714285714285714,-0.14285714285714285
143939,4,3,0,0,7,0.5714285714285714,-0.14285714285714285
275020,7,5,0,2,14,0.5,-0.14285714285714285
243491,4,3,0,0,7,0.5714285714285714,-0.14285714285714285
88288,4,3,0,0,7,0.5714285714285714,-0.14285714285714285
198840,4,3,0,0,7,0.5714285714285714,-0.14285714285714285
247201,4,3,0,0,7,0.5714285714285714,-0.14285714285714285
167722,3,2,0,2,7,0.42857142857142855,-0.14285714285714285
25996,4,3,0,0,7,0.5714285714285714,-0.14285714285714285
196099,4,3,0,0,7,0.5714285714285714,-0.14285714285714285
262541,7,5,0,2,14,0.5,-0.14285714285714285
58389,4,3,0,0,7,0.5714285714285714,-0.14285714285714285
651,4,3,0,0,7,0.5714285714285714,-0.14285714285714285
123608,8,6,0,0,14,0.5714285714285714,-0.14285714285714285
82608,4,3,0,0,7,0.5714285714285714,-0.14285714285714285
33999,8,6,0,0,14,0.5714285714285714,-0.14285714285714285
221327,4,3,0,0,7,0.5714285714285714,-0.14285714285714285
121547,4,3,0,0,7,0.5714285714285714,-0.14285714285714285
248965,4,3,0,0,7,0.5714285714285714,-0.14285714285714285
123143,3,2,0,2,7,0.42857142857142855,-0.14285714285714285
261611,4,3,0,0,7,0.5714285714285714,-0.14285714285714285
24846,4,3,0,0,7,0.5714285714285714,-0.14285714285714285
211176,4,3,0,0,7,0.5714285714285714,-0.14285714285714285
240677,4,3,0,0,7,0.5714285714285714,-0.14285714285714285
58964,4,3,0,0,7,0.5714285714285714,-0.14285714285714285
90517,4,3,0,0,7,0.5714285714285714,-0.14285714285714285
248479,4,3,0,0,7,0.5714285714285714,-0.14285714285714285
147900,4,3,0,0,7,0.5714285714285714,-0.14285714285714285
138018,4,3,0,0,7,0.5714285714285714,-0.14285714285714285
8454,30,22,0,5,57,0.5263157894736842,-0.14035087719298245
223787,23,17,0,3,43,0.5348837209302325,-0.13953488372093023
240700,20,15,0,1,36,0.5555555555555556,-0.1388888888888889
196466,16,12,0,1,29,0.5517241379310345,-0.13793103448275862
264311,12,9,0,1,22,0.5454545454545454,-0.13636363636363635
112026,11,8,0,3,22,0.5,-0.13636363636363635
241548,12,9,0,1,22,0.5454545454545454,-0.13636363636363635
30029,8,6,0,1,15,0.5333333333333333,-0.13333333333333333
16246,8,6,0,1,15,0.5333333333333333,-0.13333333333333333
47856,7,5,1,2,15,0.4666666666666667,-0.13333333333333333
169233,8,6,0,1,15,0.5333333333333333,-0.13333333333333333
113519,38,29,0,1,68,0.5588235294117647,-0.1323529411764706
259930,12,9,1,1,23,0.5217391304347826,-0.13043478260869565
177091,12,9,0,2,23,0.5217391304347826,-0.13043478260869565
143968,12,9,0,2,23,0.5217391304347826,-0.13043478260869565
2891,12,9,0,2,23,0.5217391304347826,-0.13043478260869565
180042,12,9,0,2,23,0.5217391304347826,-0.13043478260869565
131855,9,6,0,8,23,0.391304347826087,-0.13043478260869565
86202,17,13,0,1,31,0.5483870967741935,-0.12903225806451613
130474,22,17,0,0,39,0.5641025641025641,-0.1282051282051282
150968,20,15,0,4,39,0.5128205128205128,-0.1282051282051282
55493,20,15,0,4,39,0.5128205128205128,-0.1282051282051282
251422,22,16,0,9,47,0.46808510638297873,-0.1276595744680851
124876,31,24,0,0,55,0.5636363636363636,-0.12727272727272726
96554,8,6,0,2,16,0.5,-0.125
168034,9,7,0,0,16,0.5625,-0.125
246776,8,6,0,2,16,0.5,-0.125
246528,4,3,0,1,8,0.5,-0.125
251744,4,3,0,1,8,0.5,-0.125
95360,4,3,0,1,8,0.5,-0.125
49771,8,6,0,2,16,0.5,-0.125
173111,8,6,0,2,16,0.5,-0.125
195374,4,3,0,1,8,0.5,-0.125
200422,9,7,0,0,16,0.5625,-0.125
200568,4,3,0,1,8,0.5,-0.125
133706,12,9,0,3,24,0.5,-0.125
178223,4,3,0,1,8,0.5,-0.125
244070,4,3,0,1,8,0.5,-0.125
115700,4,3,0,1,8,0.5,-0.125
47316,30,23,0,3,56,0.5357142857142857,-0.125
225435,4,3,0,1,8,0.5,-0.125
31040,9,7,0,0,16,0.5625,-0.125
239468,3,2,0,3,8,0.375,-0.125
263645,8,6,0,2,16,0.5,-0.125
208410,2,1,0,5,8,0.25,-0.125
19664,13,10,0,1,24,0.5416666666666666,-0.125
162538,4,3,0,1,8,0.5,-0.125
203380,4,3,0,1,8,0.5,-0.125
228313,3,2,0,3,8,0.375,-0.125
8362,9,7,0,0,16,0.5625,-0.125
84146,4,3,0,1,8,0.5,-0.125
124310,13,10,0,1,24,0.5416666666666666,-0.125
36673,4,3,0,1,8,0.5,-0.125
51511,4,3,0,1,8,0.5,-0.125
211041,4,3,0,1,8,0.5,-0.125
97515,4,3,0,1,8,0.5,-0.125
56654,4,3,0,1,8,0.5,-0.125
197206,9,7,0,0,16,0.5625,-0.125
167349,9,7,0,0,16,0.5625,-0.125
64449,3,2,0,3,8,0.375,-0.125
2766,17,13,0,3,33,0.5151515151515151,-0.12121212121212122
148744,32,25,0,2,59,0.5423728813559322,-0.11864406779661017
242309,9,7,0,1,17,0.5294117647058824,-0.11764705882352941
83287,28,22,0,1,51,0.5490196078431373,-0.11764705882352941
253629,9,7,0,1,17,0.5294117647058824,-0.11764705882352941
157799,7,5,0,5,17,0.4117647058823529,-0.11764705882352941
174892,27,21,0,3,51,0.5294117647058824,-0.11764705882352941
136491,24,19,0,0,43,0.5581395348837209,-0.11627906976744186
201526,14,11,0,1,26,0.5384615384615384,-0.11538461538461539
264525,18,14,0,3,35,0.5142857142857142,-0.11428571428571428
48494,24,19,0,1,44,0.5454545454545454,-0.11363636363636363
261105,5,4,0,0,9,0.5555555555555556,-0.1111111111111111
83235,5,4,0,0,9,0.5555555555555556,-0.1111111111111111
79736,5,4,0,0,9,0.5555555555555556,-0.1111111111111111
169309,5,4,0,0,9,0.5555555555555556,-0.1111111111111111
13995,5,4,0,0,9,0.5555555555555556,-0.1111111111111111
176887,5,4,0,0,9,0.5555555555555556,-0.1111111111111111
110165,5,4,0,0,9,0.5555555555555556,-0.1111111111111111
138379,5,4,0,0,9,0.5555555555555556,-0.1111111111111111
168954,19,15,0,2,36,0.5277777777777778,-0.1111111111111111
122782,5,4,0,0,9,0.5555555555555556,-0.1111111111111111
13082,5,4,0,0,9,0.5555555555555556,-0.1111111111111111
211098,5,4,0,0,9,0.5555555555555556,-0.1111111111111111
31948,5,4,0,0,9,0.5555555555555556,-0.1111111111111111
114217,4,3,0,2,9,0.4444444444444444,-0.1111111111111111
52002,5,4,0,0,9,0.5555555555555556,-0.1111111111111111
221557,5,4,0,0,9,0.5555555555555556,-0.1111111111111111
241042,5,4,0,0,9,0.5555555555555556,-0.1111111111111111
4221,4,3,0,2,9,0.4444444444444444,-0.1111111111111111
253964,5,4,0,0,9,0.5555555555555556,-0.1111111111111111
203401,10,8,0,0,18,0.5555555555555556,-0.1111111111111111
170256,5,4,0,0,9,0.5555555555555556,-0.1111111111111111
177862,5,4,0,0,9,0.5555555555555556,-0.1111111111111111
81249,5,4,0,0,9,0.5555555555555556,-0.1111111111111111
210923,5,4,0,0,9,0.5555555555555556,-0.1111111111111111
13221,3,2,0,4,9,0.3333333333333333,-0.1111111111111111
223530,5,4,0,0,9,0.5555555555555556,-0.1111111111111111
246470,5,4,0,0,9,0.5555555555555556,-0.1111111111111111
29204,5,4,0,0,9,0.5555555555555556,-0.1111111111111111
157252,5,4,0,0,9,0.5555555555555556,-0.1111111111111111
165914,5,4,0,0,9,0.5555555555555556,-0.1111111111111111
188490,5,4,0,0,9,0.5555555555555556,-0.1111111111111111
236943,5,4,0,0,9,0.5555555555555556,-0.1111111111111111
138515,5,4,0,0,9,0.5555555555555556,-0.1111111111111111
199016,5,4,0,0,9,0.5555555555555556,-0.1111111111111111
222210,5,4,0,0,9,0.5555555555555556,-0.1111111111111111
251122,5,4,0,0,9,0.5555555555555556,-0.1111111111111111
5439,4,3,0,2,9,0.4444444444444444,-0.1111111111111111
16781,5,4,0,0,9,0.5555555555555556,-0.1111111111111111
220586,5,4,0,0,9,0.5555555555555556,-0.1111111111111111
171050,5,4,0,0,9,0.5555555555555556,-0.1111111111111111
167844,5,4,0,0,9,0.5555555555555556,-0.1111111111111111
50749,4,3,0,2,9,0.4444444444444444,-0.1111111111111111
200402,5,4,0,0,9,0.5555555555555556,-0.1111111111111111
217818,5,4,0,0,9,0.5555555555555556,-0.1111111111111111
12784,5,4,0,0,9,0.5555555555555556,-0.1111111111111111
12569,5,4,0,0,9,0.5555555555555556,-0.1111111111111111
206775,2,1,0,6,9,0.2222222222222222,-0.1111111111111111
222353,5,4,0,0,9,0.5555555555555556,-0.1111111111111111
238065,15,12,0,0,27,0.5555555555555556,-0.1111111111111111
177375,19,15,0,3,37,0.5135135135135135,-0.10810810810810811
154345,17,13,0,7,37,0.4594594594594595,-0.10810810810810811
152946,19,15,0,3,37,0.5135135135135135,-0.10810810810810811
95932,29,23,0,4,56,0.5178571428571429,-0.10714285714285714
121606,14,11,0,3,28,0.5,-0.10714285714285714
150561,15,12,0,1,28,0.5357142857142857,-0.10714285714285714
159033,25,20,0,2,47,0.5319148936170213,-0.10638297872340426
108405,24,19,0,4,47,0.5106382978723404,-0.10638297872340426
187517,22,17,0,9,48,0.4583333333333333,-0.10416666666666667
207499,16,13,0,0,29,0.5517241379310345,-0.10344827586206896
132572,5,4,0,1,10,0.5,-0.1
1424,11,9,0,0,20,0.55,-0.1
148263,5,4,0,1,10,0.5,-0.1
261037,4,3,0,3,10,0.4,-0.1
80820,5,4,0,1,10,0.5,-0.1
127826,21,17,0,2,40,0.525,-0.1
57725,11,9,0,0,20,0.55,-0.1
69188,5,4,0,1,10,0.5,-0.1
16121,5,4,0,1,10,0.5,-0.1
203280,5,4,0,1,10,0.5,-0.1
40505,5,4,0,1,10,0.5,-0.1
106280,5,4,0,1,10,0.5,-0.1
15651,5,4,0,1,10,0.5,-0.1
40798,5,4,0,1,10,0.5,-0.1
196502,15,12,0,3,30,0.5,-0.1
241080,5,4,0,1,10,0.5,-0.1
13279,5,4,0,1,10,0.5,-0.1
65208,5,4,0,1,10,0.5,-0.1
203799,22,18,0,0,40,0.55,-0.1
215388,5,4,0,1,10,0.5,-0.1
143211,11,9,0,0,20,0.55,-0.1
225886,17,14,0,0,31,0.5483870967741935,-0.0967741935483871
105979,45,37,0,1,83,0.5421686746987951,-0.0963855421686747
5476,11,9,0,1,21,0.5238095238095238,-0.09523809523809523
94494,10,8,0,3,21,0.47619047619047616,-0.09523809523809523
237990,22,18,0,2,42,0.5238095238095238,-0.09523809523809523
259118,11,9,0,2,22,0.5,-0.09090909090909091
142600,6,5,0,0,11,0.5454545454545454,-0.09090909090909091
244742,6,5,0,0,11,0.5454545454545454,-0.09090909090909091
258270,17,14,0,2,33,0.5151515151515151,-0.09090909090909091
5037,6,5,0,0,11,0.5454545454545454,-0.09090909090909091
265620,6,5,0,0,11,0.5454545454545454,-0.09090909090909091
41364,6,5,0,0,11,0.5454545454545454,-0.09090909090909091
92156,6,5,0,0,11,0.5454545454545454,-0.09090909090909091
85962,5,4,0,2,11,0.45454545454545453,-0.09090909090909091
224923,6,5,0,0,11,0.5454545454545454,-0.09090909090909091
172180,1,0,0,10,11,0.09090909090909091,-0.09090909090909091
278535,6,5,0,0,11,0.5454545454545454,-0.09090909090909091
59180,6,5,0,0,11,0.5454545454545454,-0.09090909090909091
132188,5,4,0,2,11,0.45454545454545453,-0.09090909090909091
37644,29,24,0,2,55,0.5272727272727272,-0.09090909090909091
76803,6,5,0,0,11,0.5454545454545454,-0.09090909090909091
173131,6,5,0,0,11,0.5454545454545454,-0.09090909090909091
38654,6,5,0,0,11,0.5454545454545454,-0.09090909090909091
228321,6,5,0,0,11,0.5454545454545454,-0.09090909090909091
67402,6,5,0,0,11,0.5454545454545454,-0.09090909090909091
236322,6,5,0,0,11,0.5454545454545454,-0.09090909090909091
70065,8,6,0,8,22,0.36363636363636365,-0.09090909090909091
81977,17,14,0,2,33,0.5151515151515151,-0.09090909090909091
105627,6,5,0,0,11,0.5454545454545454,-0.09090909090909091
98787,22,18,0,4,44,0.5,-0.09090909090909091
181212,5,4,0,2,11,0.45454545454545453,-0.09090909090909091
70379,6,5,0,0,11,0.5454545454545454,-0.09090909090909091
10030,6,5,0,0,11,0.5454545454545454,-0.09090909090909091
106208,5,4,0,2,11,0.45454545454545453,-0.09090909090909091
118677,6,5,0,0,11,0.5454545454545454,-0.09090909090909091
137684,6,5,0,0,11,0.5454545454545454,-0.09090909090909091
147678,6,5,0,0,11,0.5454545454545454,-0.09090909090909091
74665,6,5,0,0,11,0.5454545454545454,-0.09090909090909091
258151,6,5,0,0,11,0.5454545454545454,-0.09090909090909091
118533,6,5,0,0,11,0.5454545454545454,-0.09090909090909091
201684,18,15,0,1,34,0.5294117647058824,-0.08823529411764706
206534,29,24,0,4,57,0.5087719298245614,-0.08771929824561403
223438,11,9,0,3,23,0.4782608695652174,-0.08695652173913043
174216,18,15,0,2,35,0.5142857142857142,-0.08571428571428572
229741,44,37,0,2,83,0.5301204819277109,-0.08433734939759036
70014,6,5,0,1,12,0.5,-0.08333333333333333
117594,6,5,0,1,12,0.5,-0.08333333333333333
9354,6,5,0,1,12,0.5,-0.08333333333333333
22365,6,5,0,1,12,0.5,-0.08333333333333333
88389,6,5,0,1,12,0.5,-0.08333333333333333
154543,6,5,0,1,12,0.5,-0.08333333333333333
8253,25,21,0,2,48,0.5208333333333334,-0.08333333333333333
180495,6,5,0,1,12,0.5,-0.08333333333333333
117873,12,10,0,2,24,0.5,-0.08333333333333333
93046,6,5,0,1,12,0.5,-0.08333333333333333
67663,12,10,1,1,24,0.5,-0.08333333333333333
241565,6,5,0,1,12,0.5,-0.08333333333333333
136561,6,5,0,1,12,0.5,-0.08333333333333333
177683,6,5,0,1,12,0.5,-0.08333333333333333
179734,26,22,0,0,48,0.5416666666666666,-0.08333333333333333
103541,2,1,0,9,12,0.16666666666666666,-0.08333333333333333
111190,13,11,0,1,25,0.52,-0.08
37989,7,6,0,0,13,0.5384615384615384,-0.07692307692307693
35918,14,12,0,0,26,0.5384615384615384,-0.07692307692307693
39281,32,27,0,6,65,0.49230769230769234,-0.07692307692307693
224904,6,5,0,2,13,0.46153846153846156,-0.07692307692307693
99630,6,5,0,2,13,0.46153846153846156,-0.07692307692307693
19573,7,6,0,0,13,0.5384615384615384,-0.07692307692307693
125692,13,11,0,2,26,0.5,-0.07692307692307693
275922,7,6,0,0,13,0.5384615384615384,-0.07692307692307693
187904,7,6,0,0,13,0.5384615384615384,-0.07692307692307693
253482,6,5,0,2,13,0.46153846153846156,-0.07692307692307693
268833,6,5,0,2,13,0.46153846153846156,-0.07692307692307693
113435,7,6,0,0,13,0.5384615384615384,-0.07692307692307693
276521,7,6,0,0,13,0.5384615384615384,-0.07692307692307693
184279,7,6,0,0,13,0.5384615384615384,-0.07692307692307693
253871,27,23,0,2,52,0.5192307692307693,-0.07692307692307693
55799,13,11,0,2,26,0.5,-0.07692307692307693
121986,7,6,0,0,13,0.5384615384615384,-0.07692307692307693
114868,22,18,0,14,54,0.4074074074074074,-0.07407407407407407
238613,13,11,0,3,27,0.48148148148148145,-0.07407407407407407
204813,14,12,0,1,27,0.5185185185185185,-0.07407407407407407
77809,21,18,0,2,41,0.5121951219512195,-0.07317073170731707
252347,7,6,0,1,14,0.5,-0.07142857142857142
11245,15,13,0,0,28,0.5357142857142857,-0.07142857142857142
92152,7,6,0,1,14,0.5,-0.07142857142857142
21252,6,5,0,3,14,0.42857142857142855,-0.07142857142857142
178035,7,6,0,1,14,0.5,-0.07142857142857142
24627,7,6,0,1,14,0.5,-0.07142857142857142
49889,6,5,0,3,14,0.42857142857142855,-0.07142857142857142
207616,21,18,0,3,42,0.5,-0.07142857142857142
62966,9,7,0,12,28,0.32142857142857145,-0.07142857142857142
146803,22,19,0,2,43,0.5116279069767442,-0.06976744186046512
244685,30,26,0,3,59,0.5084745762711864,-0.06779661016949153
235146,8,7,0,0,15,0.5333333333333333,-0.06666666666666667
138602,16,14,0,0,30,0.5333333333333333,-0.06666666666666667
270554,13,11,0,6,30,0.43333333333333335,-0.06666666666666667
236959,7,6,0,2,15,0.4666666666666667,-0.06666666666666667
133284,7,6,0,2,15,0.4666666666666667,-0.06666666666666667
82407,15,13,0,2,30,0.5,-0.06666666666666667
154730,8,7,0,0,15,0.5333333333333333,-0.06666666666666667
239626,8,7,0,0,15,0.5333333333333333,-0.06666666666666667
81216,8,7,0,0,15,0.5333333333333333,-0.06666666666666667
74453,8,7,0,0,15,0.5333333333333333,-0.06666666666666667
136139,24,21,0,2,47,0.5106382978723404,-0.06382978723404255
224138,32,28,0,3,63,0.5079365079365079,-0.06349206349206349
65584,32,28,0,4,64,0.5,-0.0625
168388,8,7,0,1,16,0.5,-0.0625
124983,8,7,0,1,16,0.5,-0.0625
147965,8,7,0,1,16,0.5,-0.0625
245568,7,6,0,3,16,0.4375,-0.0625
201783,7,6,0,3,16,0.4375,-0.0625
100578,7,6,0,3,16,0.4375,-0.0625
115490,17,15,0,0,32,0.53125,-0.0625
232990,8,7,0,1,16,0.5,-0.0625
30711,26,23,0,1,50,0.52,-0.06
197775,9,8,0,0,17,0.5294117647058824,-0.058823529411764705
166922,6,5,0,6,17,0.35294117647058826,-0.058823529411764705
87911,8,7,0,2,17,0.47058823529411764,-0.058823529411764705
239535,9,8,0,0,17,0.5294117647058824,-0.058823529411764705
91647,9,8,0,0,17,0.5294117647058824,-0.058823529411764705
27875,8,7,0,2,17,0.47058823529411764,-0.058823529411764705
67079,1,0,0,16,17,0.058823529411764705,-0.058823529411764705
115003,45,40,0,1,86,0.5232558139534884,-0.05813953488372093
87938,18,16,0,2,36,0.5,-0.05555555555555555
183196,9,8,0,1,18,0.5,-0.05555555555555555
233911,9,8,0,1,18,0.5,-0.05555555555555555
91103,19,17,0,0,36,0.5277777777777778,-0.05555555555555555
238120,18,16,0,2,36,0.5,-0.05555555555555555
218121,28,25,0,2,55,0.509090909090909,-0.05454545454545454
212923,19,17,0,1,37,0.5135135135135135,-0.05405405405405406
178240,10,9,0,0,19,0.5263157894736842,-0.05263157894736842
141511,10,9,0,0,19,0.5263157894736842,-0.05263157894736842
99347,6,5,0,8,19,0.3157894736842105,-0.05263157894736842
138578,18,16,0,4,38,0.47368421052631576,-0.05263157894736842
94985,10,9,0,0,19,0.5263157894736842,-0.05263157894736842
113663,9,8,0,3,20,0.45,-0.05
274393,10,9,0,1,20,0.5,-0.05
108155,10,9,0,2,21,0.47619047619047616,-0.047619047619047616
231210,31,28,0,4,63,0.49206349206349204,-0.047619047619047616
242299,20,18,0,4,42,0.47619047619047616,-0.047619047619047616
141958,11,10,0,0,21,0.5238095238095238,-0.047619047619047616
86835,11,10,0,0,21,0.5238095238095238,-0.047619047619047616
106007,34,31,0,0,65,0.5230769230769231,-0.046153846153846156
73394,11,10,0,1,22,0.5,-0.045454545454545456
42458,10,9,0,3,22,0.45454545454545453,-0.045454545454545456
152186,21,19,0,4,44,0.4772727272727273,-0.045454545454545456
17003,22,20,0,3,45,0.4888888888888889,-0.044444444444444446
2110,12,11,0,0,23,0.5217391304347826,-0.043478260869565216
246507,10,9,0,4,23,0.43478260869565216,-0.043478260869565216
28619,10,9,0,4,23,0.43478260869565216,-0.043478260869565216
264317,11,10,0,2,23,0.4782608695652174,-0.043478260869565216
172030,11,10,0,2,23,0.4782608695652174,-0.043478260869565216
113904,12,11,0,0,23,0.5217391304347826,-0.043478260869565216
40889,36,33,0,3,72,0.5,-0.041666666666666664
209174,12,11,0,1,24,0.5,-0.041666666666666664
140662,13,12,0,4,29,0.4482758620689655,-0.034482758620689655
34588,15,14,0,1,30,0.5,-0.03333333333333333
167812,14,13,0,3,30,0.4666666666666667,-0.03333333333333333
105214,15,14,0,2,31,0.4838709677419355,-0.03225806451612903
217375,15,14,0,3,32,0.46875,-0.03125
243930,16,15,0,1,32,0.5,-0.03125
28204,15,14,0,4,33,0.45454545454545453,-0.030303030303030304
249862,16,15,0,3,34,0.47058823529411764,-0.029411764705882353
84024,18,17,0,0,35,0.5142857142857142,-0.02857142857142857
164323,36,34,0,2,72,0.5,-0.027777777777777776
258938,18,17,0,1,36,0.5,-0.027777777777777776
243294,19,18,0,0,37,0.5135135135135135,-0.02702702702702703
276231,19,18,0,1,38,0.5,-0.02631578947368421
16106,17,16,0,5,38,0.4473684210526316,-0.02631578947368421
119575,21,20,0,3,44,0.4772727272727273,-0.022727272727272728
88693,49,47,0,1,97,0.5051546391752577,-0.020618556701030927
69971,24,23,0,2,49,0.4897959183673469,-0.02040816326530612
249628,24,23,0,2,49,0.4897959183673469,-0.02040816326530612
97754,23,22,0,5,50,0.46,-0.02
82497,26,25,0,3,54,0.48148148148148145,-0.018518518518518517
32773,24,23,0,10,57,0.42105263157894735,-0.017543859649122806
73681,28,27,0,4,59,0.4745762711864407,-0.01694915254237288
52584,28,27,0,6,61,0.45901639344262296,-0.01639344262295082
13273,31,30,0,1,62,0.5,-0.016129032258064516
223501,38,37,0,3,78,0.48717948717948717,-0.01282051282051282
249688,3,3,0,0,6,0.5,0.0
193106,3,3,0,0,6,0.5,0.0
174501,3,3,0,0,6,0.5,0.0
136465,2,2,0,1,5,0.4,0.0
174428,6,6,0,0,12,0.5,0.0
249746,3,3,0,0,6,0.5,0.0
188951,4,4,0,2,10,0.4,0.0
249958,7,7,0,0,14,0.5,0.0
129725,2,2,0,1,5,0.4,0.0
214102,3,3,0,0,6,0.5,0.0
250184,11,11,0,1,23,0.4782608695652174,0.0
220892,3,3,0,0,6,0.5,0.0
174179,5,5,0,0,10,0.5,0.0
258240,4,4,0,2,10,0.4,0.0
250939,3,3,0,0,6,0.5,0.0
250683,4,4,0,1,9,0.4444444444444444,0.0
258160,3,3,0,1,7,0.42857142857142855,0.0
194514,3,3,0,0,6,0.5,0.0
194699,2,2,0,1,5,0.4,0.0
220240,11,11,0,2,24,0.4583333333333333,0.0
170861,5,5,0,1,11,0.45454545454545453,0.0
192191,3,3,0,0,6,0.5,0.0
194172,5,5,0,2,12,0.4166666666666667,0.0
276050,15,15,0,3,33,0.45454545454545453,0.0
190844,7,7,0,1,15,0.4666666666666667,0.0
218714,2,2,0,1,5,0.4,0.0
276670,4,4,0,2,10,0.4,0.0
133041,3,3,0,1,7,0.42857142857142855,0.0
218636,3,3,0,0,6,0.5,0.0
255661,3,3,0,0,6,0.5,0.0
212631,3,3,0,0,6,0.5,0.0
132663,4,4,0,0,8,0.5,0.0
169692,0,0,0,6,6,0.0,0.0
169781,3,3,0,0,6,0.5,0.0
255493,2,2,0,1,5,0.4,0.0
217811,5,5,0,0,10,0.5,0.0
253821,8,8,0,0,16,0.5,0.0
259004,3,3,0,3,9,0.3333333333333333,0.0
170255,3,3,0,0,6,0.5,0.0
191761,3,3,0,0,6,0.5,0.0
170518,3,3,0,0,6,0.5,0.0
254355,3,3,0,1,7,0.42857142857142855,0.0
169663,16,16,0,2,34,0.47058823529411764,0.0
169223,3,3,0,0,6,0.5,0.0
275994,5,5,0,0,10,0.5,0.0
174034,4,4,0,0,8,0.5,0.0
192492,3,3,0,0,6,0.5,0.0
135398,3,3,0,0,6,0.5,0.0
219597,3,3,0,0,6,0.5,0.0
266872,4,4,0,0,8,0.5,0.0
251721,3,3,0,0,6,0.5,0.0
135329,3,3,0,0,6,0.5,0.0
134900,3,3,0,0,6,0.5,0.0
257534,3,3,0,0,6,0.5,0.0
196031,5,5,0,0,10,0.5,0.0
215693,3,3,0,0,6,0.5,0.0
257212,3,3,0,0,6,0.5,0.0
168144,8,8,0,1,17,0.47058823529411764,0.0
195943,4,4,0,0,8,0.5,0.0
134005,7,7,0,0,14,0.5,0.0
189855,6,6,0,0,12,0.5,0.0
171007,1,1,0,3,5,0.2,0.0
219278,4,4,0,0,8,0.5,0.0
195041,3,3,0,0,6,0.5,0.0
194974,2,2,0,1,5,0.4,0.0
252775,2,2,0,1,5,0.4,0.0
219065,3,3,0,0,6,0.5,0.0
219035,3,3,0,0,6,0.5,0.0
170966,3,3,0,0,6,0.5,0.0
129883,5,5,0,0,10,0.5,0.0
179744,5,5,0,1,11,0.45454545454545453,0.0
142017,3,3,0,0,6,0.5,0.0
196149,3,3,0,2,8,0.375,0.0
208251,4,4,0,2,10,0.4,0.0
148030,4,4,0,0,8,0.5,0.0
227681,5,5,0,0,10,0.5,0.0
227771,2,2,0,1,5,0.4,0.0
240107,3,3,0,0,6,0.5,0.0
239748,3,3,0,0,6,0.5,0.0
274325,8,8,0,1,17,0.47058823529411764,0.0
208058,2,2,0,1,5,0.4,0.0
149084,5,5,0,1,11,0.45454545454545453,0.0
239554,4,4,0,0,8,0.5,0.0
229243,3,3,0,0,6,0.5,0.0
229313,20,20,0,0,40,0.5,0.0
160571,13,13,0,1,27,0.48148148148148145,0.0
229496,0,0,0,6,6,0.0,0.0
203621,3,3,0,0,6,0.5,0.0
227544,3,3,0,0,6,0.5,0.0
208302,2,2,0,1,5,0.4,0.0
227072,4,4,0,0,8,0.5,0.0
183958,2,2,0,3,7,0.2857142857142857,0.0
225810,10,10,0,2,22,0.45454545454545453,0.0
145644,2,2,0,1,5,0.4,0.0
242269,2,2,0,2,6,0.3333333333333333,0.0
242097,2,2,0,1,5,0.4,0.0
208568,7,7,0,0,14,0.5,0.0
270605,23,23,0,3,49,0.46938775510204084,0.0
226739,3,3,0,0,6,0.5,0.0
150554,3,3,0,0,6,0.5,0.0
162827,5,5,0,4,14,0.35714285714285715,0.0
146421,3,3,0,1,7,0.42857142857142855,0.0
146573,3,3,0,0,6,0.5,0.0
146778,3,3,0,2,8,0.375,0.0
226772,6,6,0,1,13,0.46153846153846156,0.0
202182,3,3,0,0,6,0.5,0.0
208382,6,6,0,0,12,0.5,0.0
147420,7,7,0,0,14,0.5,0.0
202063,2,2,0,1,5,0.4,0.0
177073,4,4,0,1,9,0.4444444444444444,0.0
239481,4,4,0,0,8,0.5,0.0
207275,5,5,0,1,11,0.45454545454545453,0.0
152742,4,4,0,1,9,0.4444444444444444,0.0
236044,2,2,0,1,5,0.4,0.0
231823,3,3,0,1,7,0.42857142857142855,0.0
231897,6,6,0,1,13,0.46153846153846156,0.0
157083,2,2,0,1,5,0.4,0.0
181165,4,4,0,0,8,0.5,0.0
181103,2,2,0,1,5,0.4,0.0
154137,3,3,0,0,6,0.5,0.0
156584,8,8,0,0,16,0.5,0.0
262271,3,3,0,0,6,0.5,0.0
206109,6,6,0,0,12,0.5,0.0
232583,4,4,0,0,8,0.5,0.0
156342,3,3,0,0,6,0.5,0.0
180032,5,5,0,0,10,0.5,0.0
205878,1,1,0,4,6,0.16666666666666666,0.0
236097,4,4,0,0,8,0.5,0.0
152617,2,2,0,1,5,0.4,0.0
236587,3,3,0,0,6,0.5,0.0
181736,3,3,0,0,6,0.5,0.0
239067,3,3,0,1,7,0.42857142857142855,0.0
159834,9,9,0,2,20,0.45,0.0
206959,6,6,0,0,12,0.5,0.0
204660,2,2,0,1,5,0.4,0.0
159754,3,3,0,0,6,0.5,0.0
204698,3,3,0,0,6,0.5,0.0
159283,1,1,0,3,5,0.2,0.0
214879,6,6,0,0,12,0.5,0.0
238568,2,2,0,1,5,0.4,0.0
151824,4,4,0,5,13,0.3076923076923077,0.0
237397,2,2,0,1,5,0.4,0.0
157660,3,3,0,0,6,0.5,0.0
231560,3,3,0,1,7,0.42857142857142855,0.0
265276,4,4,0,0,8,0.5,0.0
236994,3,3,0,0,6,0.5,0.0
267444,5,5,0,0,10,0.5,0.0
158034,3,3,0,0,6,0.5,0.0
188799,5,5,0,0,10,0.5,0.0
242843,3,3,0,0,6,0.5,0.0
208600,5,5,0,1,11,0.45454545454545453,0.0
259829,3,3,0,1,7,0.42857142857142855,0.0
188369,2,2,0,2,6,0.3333333333333333,0.0
197997,4,4,0,0,8,0.5,0.0
210573,5,5,0,0,10,0.5,0.0
166758,4,4,0,0,8,0.5,0.0
210493,2,2,0,2,6,0.3333333333333333,0.0
166646,3,3,0,0,6,0.5,0.0
246798,5,5,0,0,10,0.5,0.0
198982,2,2,0,1,5,0.4,0.0
138955,2,2,0,1,5,0.4,0.0
187981,4,4,0,0,8,0.5,0.0
139206,3,3,0,0,6,0.5,0.0
246655,5,5,0,4,14,0.35714285714285715,0.0
139287,3,3,0,0,6,0.5,0.0
139548,2,2,0,1,5,0.4,0.0
197942,3,3,0,0,6,0.5,0.0
188484,2,2,0,2,6,0.3333333333333333,0.0
269719,6,6,0,0,12,0.5,0.0
138307,2,2,1,0,5,0.4,0.0
137524,2,2,0,1,5,0.4,0.0
248901,2,2,0,1,5,0.4,0.0
137688,20,20,0,3,43,0.46511627906976744,0.0
248656,6,6,0,0,12,0.5,0.0
221777,4,4,0,0,8,0.5,0.0
188659,9,9,0,1,19,0.47368421052631576,0.0
137986,2,2,0,1,5,0.4,0.0
139575,2,2,0,1,5,0.4,0.0
248496,11,11,0,0,22,0.5,0.0
138100,3,3,0,0,6,0.5,0.0
248221,6,6,0,0,12,0.5,0.0
138124,3,3,0,0,6,0.5,0.0
196228,3,3,0,0,6,0.5,0.0
222152,3,3,0,2,8,0.375,0.0
247897,2,2,0,2,6,0.3333333333333333,0.0
138202,6,6,0,0,12,0.5,0.0
138073,1,1,0,4,6,0.16666666666666666,0.0
145165,4,4,0,1,9,0.4444444444444444,0.0
223132,3,3,0,1,7,0.42857142857142855,0.0
140196,3,3,0,0,6,0.5,0.0
244092,2,2,0,1,5,0.4,0.0
185275,7,7,0,0,14,0.5,0.0
164518,3,3,0,0,6,0.5,0.0
143497,6,6,0,1,13,0.46153846153846156,0.0
176785,3,3,0,0,6,0.5,0.0
243951,8,8,0,0,16,0.5,0.0
143965,4,4,0,0,8,0.5,0.0
144151,4,4,0,0,8,0.5,0.0
201058,6,6,0,1,13,0.46153846153846156,0.0
243891,4,4,0,0,8,0.5,0.0
184904,5,5,0,0,10,0.5,0.0
243429,3,3,0,0,6,0.5,0.0
176903,3,3,0,1,7,0.42857142857142855,0.0
144619,8,8,0,0,16,0.5,0.0
224944,4,4,0,0,8,0.5,0.0
209156,2,2,0,2,6,0.3333333333333333,0.0
244627,36,36,0,7,79,0.45569620253164556,0.0
142823,3,3,0,0,6,0.5,0.0
223954,6,6,0,0,12,0.5,0.0
187425,4,4,0,1,9,0.4444444444444444,0.0
187410,4,4,0,0,8,0.5,0.0
165425,3,3,0,0,6,0.5,0.0
175536,3,3,0,1,7,0.42857142857142855,0.0
141047,2,2,0,1,5,0.4,0.0
209229,8,8,0,1,17,0.47058823529411764,0.0
245655,5,5,0,0,10,0.5,0.0
209974,8,8,0,1,17,0.47058823529411764,0.0
175978,6,6,0,0,12,0.5,0.0
245215,3,3,0,0,6,0.5,0.0
141902,9,9,0,1,19,0.47368421052631576,0.0
142005,3,3,0,0,6,0.5,0.0
142143,4,4,0,0,8,0.5,0.0
142253,3,3,0,0,6,0.5,0.0
223554,3,3,0,0,6,0.5,0.0
200508,3,3,0,0,6,0.5,0.0
141871,4,4,0,0,8,0.5,0.0
172048,3,3,0,0,6,0.5,0.0
276688,6,6,0,0,12,0.5,0.0
31740,4,4,0,0,8,0.5,0.0
6577,5,5,0,1,11,0.45454545454545453,0.0
91875,3,3,0,0,6,0.5,0.0
116428,3,3,0,3,9,0.3333333333333333,0.0
42372,3,3,0,0,6,0.5,0.0
116897,3,3,0,0,6,0.5,0.0
66640,4,4,0,1,9,0.4444444444444444,0.0
91761,5,5,0,1,11,0.45454545454545453,0.0
66591,3,3,0,0,6,0.5,0.0
6431,5,5,0,0,10,0.5,0.0
31609,5,5,0,0,10,0.5,0.0
31412,4,4,0,0,8,0.5,0.0
5815,3,3,0,0,6,0.5,0.0
42948,3,3,0,0,6,0.5,0.0
66055,4,4,0,0,8,0.5,0.0
26813,2,2,0,1,5,0.4,0.0
92184,3,3,0,0,6,0.5,0.0
90776,5,5,0,0,10,0.5,0.0
31688,3,3,0,0,6,0.5,0.0
25850,5,5,0,0,10,0.5,0.0
80323,3,3,0,0,6,0.5,0.0
113334,10,10,0,6,26,0.38461538461538464,0.0
8681,22,22,0,0,44,0.5,0.0
49289,3,3,0,0,6,0.5,0.0
93018,0,0,0,9,9,0.0,0.0
114258,3,3,0,0,6,0.5,0.0
92696,3,3,0,0,6,0.5,0.0
7620,4,4,0,0,8,0.5,0.0
49212,11,11,0,0,22,0.5,0.0
115537,5,5,0,0,10,0.5,0.0
67270,7,7,0,1,15,0.4666666666666667,0.0
76710,8,8,0,0,16,0.5,0.0
67174,3,3,0,0,6,0.5,0.0
115874,0,0,0,6,6,0.0,0.0
25804,2,2,0,1,5,0.4,0.0
25919,7,7,0,0,14,0.5,0.0
113259,3,3,0,0,6,0.5,0.0
65946,3,3,0,1,7,0.42857142857142855,0.0
43595,2,2,0,2,6,0.3333333333333333,0.0
44837,3,3,0,1,7,0.42857142857142855,0.0
81950,4,4,0,4,12,0.3333333333333333,0.0
122801,7,7,0,0,14,0.5,0.0
53392,7,7,0,1,15,0.4666666666666667,0.0
44932,2,2,0,2,6,0.3333333333333333,0.0
2399,2,2,0,1,5,0.4,0.0
45068,3,3,0,0,6,0.5,0.0
2313,7,7,0,0,14,0.5,0.0
28255,5,5,0,3,13,0.38461538461538464,0.0
82164,4,4,0,1,9,0.4444444444444444,0.0
88330,3,3,0,1,7,0.42857142857142855,0.0
123543,5,5,0,1,11,0.45454545454545453,0.0
30854,3,3,0,0,6,0.5,0.0
55779,3,3,0,0,6,0.5,0.0
45418,6,6,0,1,13,0.46153846153846156,0.0
44727,3,3,0,0,6,0.5,0.0
43436,3,3,0,1,7,0.42857142857142855,0.0
121620,3,3,0,0,6,0.5,0.0
89057,3,3,0,0,6,0.5,0.0
43806,6,6,0,2,14,0.42857142857142855,0.0
43807,3,3,0,0,6,0.5,0.0
90417,11,11,0,0,22,0.5,0.0
3817,3,3,0,0,6,0.5,0.0
64846,2,2,0,1,5,0.4,0.0
27647,18,18,0,4,40,0.45,0.0
120080,3,3,0,1,7,0.42857142857142855,0.0
64535,6,6,0,0,12,0.5,0.0
64435,4,4,0,0,8,0.5,0.0
44089,2,2,0,1,5,0.4,0.0
120155,3,3,0,0,6,0.5,0.0
120178,5,5,0,0,10,0.5,0.0
44297,3,3,0,0,6,0.5,0.0
120696,5,5,0,0,10,0.5,0.0
81865,3,3,0,0,6,0.5,0.0
89014,7,7,0,1,15,0.4666666666666667,0.0
8935,3,3,0,0,6,0.5,0.0
68729,2,2,0,1,5,0.4,0.0
80266,2,2,0,1,5,0.4,0.0
21202,1,1,0,5,7,0.14285714285714285,0.0
74743,2,2,0,1,5,0.4,0.0
104123,3,3,0,0,6,0.5,0.0
35179,1,1,0,3,5,0.2,0.0
35081,4,4,0,0,8,0.5,0.0
21484,9,9,0,1,19,0.47368421052631576,0.0
74356,2,2,0,2,6,0.3333333333333333,0.0
74274,2,2,0,1,5,0.4,0.0
74106,2,2,0,2,6,0.3333333333333333,0.0
98344,3,3,0,0,6,0.5,0.0
16488,6,6,0,0,12,0.5,0.0
72990,7,7,0,2,16,0.4375,0.0
33958,2,2,0,1,5,0.4,0.0
15845,4,4,0,0,8,0.5,0.0
51665,4,4,0,1,9,0.4444444444444444,0.0
103577,3,3,0,0,6,0.5,0.0
22045,8,8,0,0,16,0.5,0.0
35188,3,3,0,1,7,0.42857142857142855,0.0
75119,4,4,0,0,8,0.5,0.0
36326,4,4,0,0,8,0.5,0.0
101035,2,2,0,3,7,0.2857142857142857,0.0
100815,4,4,0,0,8,0.5,0.0
55492,26,26,0,5,57,0.45614035087719296,0.0
100454,3,3,0,0,6,0.5,0.0
101696,3,3,0,0,6,0.5,0.0
18172,3,3,0,0,6,0.5,0.0
100053,3,3,0,0,6,0.5,0.0
20150,2,2,0,2,6,0.3333333333333333,0.0
36693,3,3,0,0,6,0.5,0.0
99616,3,3,0,0,6,0.5,0.0
20265,5,5,0,1,11,0.45454545454545453,0.0
36807,11,11,0,0,22,0.5,0.0
17233,4,4,0,0,8,0.5,0.0
98988,3,3,0,1,7,0.42857142857142855,0.0
75028,3,3,0,0,6,0.5,0.0
106816,3,3,0,0,6,0.5,0.0
22062,3,3,0,0,6,0.5,0.0
106862,3,3,0,0,6,0.5,0.0
94366,3,3,0,0,6,0.5,0.0
94362,3,3,0,1,7,0.42857142857142855,0.0
69460,2,2,0,1,5,0.4,0.0
69410,2,2,0,1,5,0.4,0.0
110493,3,3,0,0,6,0.5,0.0
11529,4,4,0,0,8,0.5,0.0
69378,14,14,0,1,29,0.4827586206896552,0.0
111390,2,2,0,2,6,0.3333333333333333,0.0
39441,6,6,0,0,12,0.5,0.0
11120,2,2,0,2,6,0.3333333333333333,0.0
80036,3,3,0,0,6,0.5,0.0
93985,3,3,0,0,6,0.5,0.0
93871,3,3,0,0,6,0.5,0.0
33036,3,3,0,0,6,0.5,0.0
39646,9,9,0,3,21,0.42857142857142855,0.0
109864,6,6,0,0,12,0.5,0.0
69775,5,5,0,0,10,0.5,0.0
38950,2,2,0,1,5,0.4,0.0
52425,3,3,0,0,6,0.5,0.0
71752,8,8,0,0,16,0.5,0.0
78573,3,3,0,0,6,0.5,0.0
78589,2,2,0,1,5,0.4,0.0
95921,7,7,0,2,16,0.4375,0.0
107244,10,10,0,1,21,0.47619047619047616,0.0
56985,3,3,0,0,6,0.5,0.0
107258,6,6,0,0,12,0.5,0.0
30824,4,4,0,0,8,0.5,0.0
95907,4,4,0,0,8,0.5,0.0
107921,3,3,0,0,6,0.5,0.0
33491,3,3,0,0,6,0.5,0.0
38091,3,3,0,1,7,0.42857142857142855,0.0
38176,4,4,0,0,8,0.5,0.0
79182,2,2,0,1,5,0.4,0.0
108622,2,2,0,1,5,0.4,0.0
70772,1,1,0,3,5,0.2,0.0
71207,4,4,0,0,8,0.5,0.0
46099,5,5,0,0,10,0.5,0.0
19362,3,3,0,0,6,0.5,0.0
28647,3,3,0,0,6,0.5,0.0
46197,2,2,0,3,7,0.2857142857142857,0.0
60392,3,3,0,0,6,0.5,0.0
124874,19,19,0,0,38,0.5,0.0
114,3,3,0,0,6,0.5,0.0
86932,3,3,0,0,6,0.5,0.0
83135,3,3,0,0,6,0.5,0.0
58224,4,4,0,0,8,0.5,0.0
124852,2,2,0,1,5,0.4,0.0
87051,5,5,0,0,10,0.5,0.0
30035,9,9,0,0,18,0.5,0.0
59499,4,4,0,0,8,0.5,0.0
83561,2,2,0,1,5,0.4,0.0
53846,7,7,0,0,14,0.5,0.0
125701,3,3,0,0,6,0.5,0.0
128406,4,4,0,0,8,0.5,0.0
127129,11,11,0,1,23,0.4782608695652174,0.0
30120,3,3,0,0,6,0.5,0.0
278137,8,8,0,0,16,0.5,0.0
125878,4,4,0,0,8,0.5,0.0
128208,8,8,0,2,18,0.4444444444444444,0.0
58768,4,4,0,0,8,0.5,0.0
84178,4,4,0,1,9,0.4444444444444444,0.0
59305,4,4,0,1,9,0.4444444444444444,0.0
86906,3,3,0,0,6,0.5,0.0
126487,3,3,0,0,6,0.5,0.0
30081,9,9,0,0,18,0.5,0.0
277928,4,4,0,0,8,0.5,0.0
59059,6,6,0,1,13,0.46153846153846156,0.0
86051,3,3,0,0,6,0.5,0.0
127893,3,3,0,0,6,0.5,0.0
83383,4,4,0,0,8,0.5,0.0
85701,5,5,0,0,10,0.5,0.0
85587,5,5,0,1,11,0.45454545454545453,0.0
127621,4,4,0,0,8,0.5,0.0
51359,3,3,0,1,7,0.42857142857142855,0.0
388,3,3,0,1,7,0.42857142857142855,0.0
127384,2,2,0,1,5,0.4,0.0
503,3,3,0,0,6,0.5,0.0
86489,6,6,0,0,12,0.5,0.0
124915,4,4,0,1,9,0.4444444444444444,0.0
85526,24,25,0,15,64,0.375,0.015625
122429,25,26,0,4,55,0.45454545454545453,0.01818181818181818
141493,23,24,0,7,54,0.42592592592592593,0.018518518518518517
145449,24,25,0,1,50,0.48,0.02
245410,45,47,0,1,93,0.4838709677419355,0.021505376344086023
238864,11,12,0,17,40,0.275,0.025
132375,18,19,0,0,37,0.4864864864864865,0.02702702702702703
128696,17,18,0,1,36,0.4722222222222222,0.027777777777777776
50225,14,15,0,5,34,0.4117647058823529,0.029411764705882353
193898,31,33,0,4,68,0.45588235294117646,0.029411764705882353
41781,16,17,0,0,33,0.48484848484848486,0.030303030303030304
15418,13,14,0,6,33,0.3939393939393939,0.030303030303030304
39773,15,16,0,0,31,0.4838709677419355,0.03225806451612903
8066,14,15,0,2,31,0.45161290322580644,0.03225806451612903
201674,13,14,0,4,31,0.41935483870967744,0.03225806451612903
135360,13,14,0,3,30,0.43333333333333335,0.03333333333333333
36003,13,14,0,3,30,0.43333333333333335,0.03333333333333333
203910,13,14,0,1,28,0.4642857142857143,0.03571428571428571
268622,12,13,1,2,28,0.42857142857142855,0.03571428571428571
145641,13,14,0,1,28,0.4642857142857143,0.03571428571428571
43842,25,27,0,2,54,0.46296296296296297,0.037037037037037035
63956,12,13,0,1,26,0.46153846153846156,0.038461538461538464
236340,37,40,0,0,77,0.4805194805194805,0.03896103896103896
98440,12,13,0,0,25,0.48,0.04
93453,12,13,0,0,25,0.48,0.04
85757,23,25,1,1,50,0.46,0.04
236172,10,11,0,4,25,0.4,0.04
60337,11,12,0,1,24,0.4583333333333333,0.041666666666666664
173415,42,46,0,5,93,0.45161290322580644,0.043010752688172046
59269,9,10,0,4,23,0.391304347826087,0.043478260869565216
141444,31,34,0,4,69,0.4492753623188406,0.043478260869565216
141491,11,12,0,0,23,0.4782608695652174,0.043478260869565216
81318,11,12,0,0,23,0.4782608695652174,0.043478260869565216
44852,11,12,0,0,23,0.4782608695652174,0.043478260869565216
264657,10,11,0,2,23,0.43478260869565216,0.043478260869565216
91832,10,11,0,1,22,0.45454545454545453,0.045454545454545456
147224,9,10,0,2,21,0.42857142857142855,0.047619047619047616
71490,10,11,0,0,21,0.47619047619047616,0.047619047619047616
104657,9,10,0,2,21,0.42857142857142855,0.047619047619047616
273979,20,22,0,0,42,0.47619047619047616,0.047619047619047616
11993,10,11,0,0,21,0.47619047619047616,0.047619047619047616
64310,10,11,0,0,21,0.47619047619047616,0.047619047619047616
132836,8,9,0,4,21,0.38095238095238093,0.047619047619047616
85993,19,21,0,1,41,0.4634146341463415,0.04878048780487805
234721,9,10,0,1,20,0.45,0.05
17667,7,8,0,5,20,0.35,0.05
226965,36,40,0,4,80,0.45,0.05
185308,7,8,0,5,20,0.35,0.05
226879,17,19,1,2,39,0.4358974358974359,0.05128205128205128
263460,8,9,0,2,19,0.42105263157894735,0.05263157894736842
246634,9,10,0,0,19,0.47368421052631576,0.05263157894736842
216829,9,10,0,0,19,0.47368421052631576,0.05263157894736842
155580,8,9,0,2,19,0.42105263157894735,0.05263157894736842
232131,52,58,0,2,112,0.4642857142857143,0.05357142857142857
263325,13,15,0,9,37,0.35135135135135137,0.05405405405405406
63625,8,9,0,1,18,0.4444444444444444,0.05555555555555555
243879,8,9,0,1,18,0.4444444444444444,0.05555555555555555
161936,8,9,0,1,18,0.4444444444444444,0.05555555555555555
154070,8,9,0,1,18,0.4444444444444444,0.05555555555555555
53174,24,27,0,3,54,0.4444444444444444,0.05555555555555555
55734,8,9,0,1,18,0.4444444444444444,0.05555555555555555
106225,23,26,0,3,52,0.4423076923076923,0.057692307692307696
201290,24,27,0,1,52,0.46153846153846156,0.057692307692307696
51252,8,9,0,0,17,0.47058823529411764,0.058823529411764705
33283,7,8,0,2,17,0.4117647058823529,0.058823529411764705
111637,8,9,0,0,17,0.47058823529411764,0.058823529411764705
150979,27,31,0,9,67,0.40298507462686567,0.05970149253731343
29259,23,26,0,1,50,0.46,0.06
67547,14,16,0,3,33,0.42424242424242425,0.06060606060606061
183347,7,8,0,1,16,0.4375,0.0625
224303,7,8,0,1,16,0.4375,0.0625
221445,21,24,0,3,48,0.4375,0.0625
53256,7,8,0,1,16,0.4375,0.0625
265751,7,8,0,1,16,0.4375,0.0625
253580,7,8,0,1,16,0.4375,0.0625
80538,20,23,0,4,47,0.425531914893617,0.06382978723404255
180651,25,29,0,7,61,0.4098360655737705,0.06557377049180328
163804,34,39,0,3,76,0.4473684210526316,0.06578947368421052
64270,7,8,0,0,15,0.4666666666666667,0.06666666666666667
150663,4,5,0,6,15,0.26666666666666666,0.06666666666666667
149934,11,13,0,6,30,0.36666666666666664,0.06666666666666667
92979,7,8,0,0,15,0.4666666666666667,0.06666666666666667
136252,13,15,0,2,30,0.43333333333333335,0.06666666666666667
104243,7,8,0,0,15,0.4666666666666667,0.06666666666666667
108535,7,8,0,0,15,0.4666666666666667,0.06666666666666667
125928,7,8,0,0,15,0.4666666666666667,0.06666666666666667
91634,7,8,0,0,15,0.4666666666666667,0.06666666666666667
208829,26,30,0,4,60,0.43333333333333335,0.06666666666666667
254160,7,8,0,0,15,0.4666666666666667,0.06666666666666667
20172,13,15,0,1,29,0.4482758620689655,0.06896551724137931
30533,26,30,0,2,58,0.4482758620689655,0.06896551724137931
108799,19,22,0,2,43,0.4418604651162791,0.06976744186046512
55187,19,22,0,2,43,0.4418604651162791,0.06976744186046512
141010,6,7,0,1,14,0.42857142857142855,0.07142857142857142
198213,6,7,0,1,14,0.42857142857142855,0.07142857142857142
123790,6,7,0,1,14,0.42857142857142855,0.07142857142857142
141719,6,7,0,1,14,0.42857142857142855,0.07142857142857142
130847,6,7,0,1,14,0.42857142857142855,0.07142857142857142
137589,24,28,0,3,55,0.43636363636363634,0.07272727272727272
268932,15,18,0,7,40,0.375,0.075
263344,5,6,0,2,13,0.38461538461538464,0.07692307692307693
55142,6,7,0,0,13,0.46153846153846156,0.07692307692307693
146078,5,6,0,2,13,0.38461538461538464,0.07692307692307693
74185,6,7,0,0,13,0.46153846153846156,0.07692307692307693
127914,6,7,0,0,13,0.46153846153846156,0.07692307692307693
167471,16,19,0,4,39,0.41025641025641024,0.07692307692307693
242007,6,7,0,0,13,0.46153846153846156,0.07692307692307693
195116,4,5,0,4,13,0.3076923076923077,0.07692307692307693
162001,6,7,0,0,13,0.46153846153846156,0.07692307692307693
173343,6,7,0,0,13,0.46153846153846156,0.07692307692307693
218552,29,34,0,2,65,0.4461538461538462,0.07692307692307693
213126,17,20,0,2,39,0.4358974358974359,0.07692307692307693
42597,6,7,0,0,13,0.46153846153846156,0.07692307692307693
237748,10,12,0,4,26,0.38461538461538464,0.07692307692307693
233711,16,19,0,3,38,0.42105263157894735,0.07894736842105263
250300,11,13,0,1,25,0.44,0.08
218568,22,26,0,2,50,0.44,0.08
243759,11,13,0,1,25,0.44,0.08
6543,34,41,0,11,86,0.3953488372093023,0.08139534883720931
229632,5,6,0,1,12,0.4166666666666667,0.08333333333333333
37974,4,5,0,3,12,0.3333333333333333,0.08333333333333333
170154,4,5,0,3,12,0.3333333333333333,0.08333333333333333
106893,3,4,0,5,12,0.25,0.08333333333333333
277965,5,6,0,1,12,0.4166666666666667,0.08333333333333333
30712,4,5,0,3,12,0.3333333333333333,0.08333333333333333
140340,5,6,0,1,12,0.4166666666666667,0.08333333333333333
211344,15,18,0,3,36,0.4166666666666667,0.08333333333333333
31094,5,6,0,1,12,0.4166666666666667,0.08333333333333333
190185,5,6,0,1,12,0.4166666666666667,0.08333333333333333
110912,37,44,0,1,82,0.45121951219512196,0.08536585365853659
272573,16,19,0,0,35,0.45714285714285713,0.08571428571428572
216444,9,11,0,3,23,0.391304347826087,0.08695652173913043
221705,15,18,0,1,34,0.4411764705882353,0.08823529411764706
250962,15,18,0,1,34,0.4411764705882353,0.08823529411764706
185634,10,12,0,0,22,0.45454545454545453,0.09090909090909091
271195,17,21,0,6,44,0.38636363636363635,0.09090909090909091
78496,5,6,0,0,11,0.45454545454545453,0.09090909090909091
72451,0,1,0,10,11,0.0,0.09090909090909091
114414,14,17,0,2,33,0.42424242424242425,0.09090909090909091
219949,5,6,0,0,11,0.45454545454545453,0.09090909090909091
15957,5,6,0,0,11,0.45454545454545453,0.09090909090909091
224249,15,18,0,0,33,0.45454545454545453,0.09090909090909091
174700,4,5,0,2,11,0.36363636363636365,0.09090909090909091
929,5,6,0,0,11,0.45454545454545453,0.09090909090909091
258084,5,6,0,0,11,0.45454545454545453,0.09090909090909091
118228,5,6,0,0,11,0.45454545454545453,0.09090909090909091
146175,4,5,0,2,11,0.36363636363636365,0.09090909090909091
4785,5,6,0,0,11,0.45454545454545453,0.09090909090909091
263383,5,6,0,0,11,0.45454545454545453,0.09090909090909091
133571,15,18,0,0,33,0.45454545454545453,0.09090909090909091
136240,5,6,0,0,11,0.45454545454545453,0.09090909090909091
55789,5,6,0,0,11,0.45454545454545453,0.09090909090909091
136193,5,6,0,0,11,0.45454545454545453,0.09090909090909091
144667,5,6,0,0,11,0.45454545454545453,0.09090909090909091
149690,4,5,0,2,11,0.36363636363636365,0.09090909090909091
19336,5,6,0,0,11,0.45454545454545453,0.09090909090909091
13126,3,4,0,4,11,0.2727272727272727,0.09090909090909091
47793,5,6,0,0,11,0.45454545454545453,0.09090909090909091
182746,5,6,0,0,11,0.45454545454545453,0.09090909090909091
16263,5,6,0,0,11,0.45454545454545453,0.09090909090909091
257492,5,6,0,0,11,0.45454545454545453,0.09090909090909091
210587,13,16,0,3,32,0.40625,0.09375
92547,12,15,0,4,31,0.3870967741935484,0.0967741935483871
255489,40,49,0,3,92,0.43478260869565216,0.09782608695652174
258534,66,81,0,6,153,0.43137254901960786,0.09803921568627451
244657,9,11,0,0,20,0.45,0.1
241597,4,5,0,1,10,0.4,0.1
9381,3,4,0,3,10,0.3,0.1
47279,4,5,0,1,10,0.4,0.1
200643,9,11,0,0,20,0.45,0.1
183753,4,5,0,1,10,0.4,0.1
275306,4,5,0,1,10,0.4,0.1
124688,2,3,0,5,10,0.2,0.1
11224,13,16,0,1,30,0.43333333333333335,0.1
16718,9,11,0,0,20,0.45,0.1
31919,4,5,0,1,10,0.4,0.1
218068,9,11,0,0,20,0.45,0.1
169735,13,16,0,1,30,0.43333333333333335,0.1
126585,4,5,0,1,10,0.4,0.1
237433,4,5,0,1,10,0.4,0.1
170499,4,5,0,1,10,0.4,0.1
120396,22,27,0,1,50,0.44,0.1
204676,4,5,0,1,10,0.4,0.1
7105,3,4,0,3,10,0.3,0.1
51365,9,11,0,0,20,0.45,0.1
116183,4,5,0,1,10,0.4,0.1
53304,9,11,0,0,20,0.45,0.1
59150,9,11,0,0,20,0.45,0.1
16601,4,5,0,1,10,0.4,0.1
173481,12,15,0,3,30,0.4,0.1
158385,4,5,0,1,10,0.4,0.1
241791,4,5,0,1,10,0.4,0.1
124078,17,21,1,0,39,0.4358974358974359,0.10256410256410256
220688,25,31,0,2,58,0.43103448275862066,0.10344827586206896
273190,8,10,0,1,19,0.42105263157894735,0.10526315789473684
84523,8,10,0,1,19,0.42105263157894735,0.10526315789473684
260944,19,24,0,4,47,0.40425531914893614,0.10638297872340426
126296,12,15,0,1,28,0.42857142857142855,0.10714285714285714
242646,12,15,0,1,28,0.42857142857142855,0.10714285714285714
168064,15,19,0,3,37,0.40540540540540543,0.10810810810810811
135673,8,12,0,17,37,0.21621621621621623,0.10810810810810811
37447,4,5,0,0,9,0.4444444444444444,0.1111111111111111
75551,4,5,0,0,9,0.4444444444444444,0.1111111111111111
137627,4,5,0,0,9,0.4444444444444444,0.1111111111111111
21576,16,20,0,0,36,0.4444444444444444,0.1111111111111111
237434,4,5,0,0,9,0.4444444444444444,0.1111111111111111
204393,8,10,0,0,18,0.4444444444444444,0.1111111111111111
271588,4,5,0,0,9,0.4444444444444444,0.1111111111111111
216099,4,5,0,0,9,0.4444444444444444,0.1111111111111111
84729,4,5,0,0,9,0.4444444444444444,0.1111111111111111
241885,4,5,0,0,9,0.4444444444444444,0.1111111111111111
196253,4,5,0,0,9,0.4444444444444444,0.1111111111111111
187863,12,15,0,0,27,0.4444444444444444,0.1111111111111111
40772,4,5,0,0,9,0.4444444444444444,0.1111111111111111
247626,3,4,0,2,9,0.3333333333333333,0.1111111111111111
176875,6,8,0,4,18,0.3333333333333333,0.1111111111111111
90614,4,5,0,0,9,0.4444444444444444,0.1111111111111111
4622,4,5,0,0,9,0.4444444444444444,0.1111111111111111
181691,4,5,0,0,9,0.4444444444444444,0.1111111111111111
95250,8,10,0,0,18,0.4444444444444444,0.1111111111111111
203161,4,5,0,0,9,0.4444444444444444,0.1111111111111111
128790,0,1,0,8,9,0.0,0.1111111111111111
105108,4,5,0,0,9,0.4444444444444444,0.1111111111111111
195965,4,5,0,0,9,0.4444444444444444,0.1111111111111111
245604,4,5,0,0,9,0.4444444444444444,0.1111111111111111
83971,4,5,0,0,9,0.4444444444444444,0.1111111111111111
116395,4,5,0,0,9,0.4444444444444444,0.1111111111111111
226713,4,5,0,0,9,0.4444444444444444,0.1111111111111111
126697,4,5,0,0,9,0.4444444444444444,0.1111111111111111
122045,2,3,0,4,9,0.2222222222222222,0.1111111111111111
206563,15,19,0,2,36,0.4166666666666667,0.1111111111111111
66960,4,5,0,0,9,0.4444444444444444,0.1111111111111111
60079,4,5,0,0,9,0.4444444444444444,0.1111111111111111
117700,4,5,0,0,9,0.4444444444444444,0.1111111111111111
167507,3,4,0,2,9,0.3333333333333333,0.1111111111111111
151991,3,4,0,2,9,0.3333333333333333,0.1111111111111111
227413,4,5,0,0,9,0.4444444444444444,0.1111111111111111
130438,4,5,0,0,9,0.4444444444444444,0.1111111111111111
45416,4,5,0,0,9,0.4444444444444444,0.1111111111111111
109605,4,5,0,0,9,0.4444444444444444,0.1111111111111111
251093,4,5,0,0,9,0.4444444444444444,0.1111111111111111
264355,4,5,0,0,9,0.4444444444444444,0.1111111111111111
53418,8,10,0,0,18,0.4444444444444444,0.1111111111111111
61901,9,12,1,4,26,0.34615384615384615,0.11538461538461539
136326,11,14,0,1,26,0.4230769230769231,0.11538461538461539
251164,11,14,0,1,26,0.4230769230769231,0.11538461538461539
95173,11,14,0,1,26,0.4230769230769231,0.11538461538461539
168816,7,9,0,1,17,0.4117647058823529,0.11764705882352941
62895,5,7,0,5,17,0.29411764705882354,0.11764705882352941
128325,7,9,0,1,17,0.4117647058823529,0.11764705882352941
253005,7,9,0,1,17,0.4117647058823529,0.11764705882352941
246617,4,6,0,7,17,0.23529411764705882,0.11764705882352941
218608,27,35,0,5,67,0.40298507462686567,0.11940298507462686
268657,9,12,0,4,25,0.36,0.12
88937,11,14,0,0,25,0.44,0.12
270801,11,14,0,0,25,0.44,0.12
157811,10,13,0,2,25,0.4,0.12
167746,11,14,0,0,25,0.44,0.12
180378,10,13,0,2,25,0.4,0.12
12538,27,35,0,4,66,0.4090909090909091,0.12121212121212122
160401,18,23,0,0,41,0.43902439024390244,0.12195121951219512
72523,7,9,0,0,16,0.4375,0.125
188483,6,8,0,2,16,0.375,0.125
200674,5,7,0,4,16,0.3125,0.125
168642,7,9,0,0,16,0.4375,0.125
155810,3,4,0,1,8,0.375,0.125
188171,3,4,0,1,8,0.375,0.125
99955,13,17,0,2,32,0.40625,0.125
170073,5,7,0,4,16,0.3125,0.125
16009,7,9,0,0,16,0.4375,0.125
238350,3,4,0,1,8,0.375,0.125
79556,3,4,0,1,8,0.375,0.125
18155,3,4,0,1,8,0.375,0.125
151104,7,9,0,0,16,0.4375,0.125
198996,3,4,0,1,8,0.375,0.125
251003,7,9,0,0,16,0.4375,0.125
170264,3,4,0,1,8,0.375,0.125
269728,5,7,0,4,16,0.3125,0.125
137211,7,9,0,0,16,0.4375,0.125
172091,7,9,0,0,16,0.4375,0.125
185771,3,4,0,1,8,0.375,0.125
28454,3,4,0,1,8,0.375,0.125
186570,10,13,0,1,24,0.4166666666666667,0.125
226482,5,7,0,4,16,0.3125,0.125
273635,3,4,0,1,8,0.375,0.125
146564,3,4,0,1,8,0.375,0.125
248468,7,9,0,0,16,0.4375,0.125
113955,6,8,0,2,16,0.375,0.125
278418,9,12,0,3,24,0.375,0.125
136237,3,4,0,1,8,0.375,0.125
58142,3,4,0,1,8,0.375,0.125
123430,7,9,0,0,16,0.4375,0.125
65663,7,9,0,0,16,0.4375,0.125
170595,3,4,0,1,8,0.375,0.125
124363,9,12,0,3,24,0.375,0.125
268156,3,4,0,1,8,0.375,0.125
58594,13,17,1,0,31,0.41935483870967744,0.12903225806451613
22074,12,16,0,3,31,0.3870967741935484,0.12903225806451613
207339,8,11,0,4,23,0.34782608695652173,0.13043478260869565
264152,10,13,0,0,23,0.43478260869565216,0.13043478260869565
139387,6,8,0,1,15,0.4,0.13333333333333333
133192,0,2,0,13,15,0.0,0.13333333333333333
28523,6,8,0,1,15,0.4,0.13333333333333333
2977,6,8,0,1,15,0.4,0.13333333333333333
91203,5,7,0,3,15,0.3333333333333333,0.13333333333333333
152651,6,8,0,1,15,0.4,0.13333333333333333
95991,15,20,0,2,37,0.40540540540540543,0.13513513513513514
171970,9,12,0,1,22,0.4090909090909091,0.13636363636363635
252865,8,11,0,3,22,0.36363636363636365,0.13636363636363635
88412,9,12,0,1,22,0.4090909090909091,0.13636363636363635
111174,12,16,0,1,29,0.41379310344827586,0.13793103448275862
152099,12,16,0,1,29,0.41379310344827586,0.13793103448275862
21659,8,12,0,9,29,0.27586206896551724,0.13793103448275862
90616,12,16,0,1,29,0.41379310344827586,0.13793103448275862
177072,27,37,0,8,72,0.375,0.1388888888888889
27740,15,20,0,1,36,0.4166666666666667,0.1388888888888889
104399,17,24,0,9,50,0.34,0.14
267180,3,4,0,0,7,0.42857142857142855,0.14285714285714285
144223,3,4,0,0,7,0.42857142857142855,0.14285714285714285
74691,5,7,0,2,14,0.35714285714285715,0.14285714285714285
31229,3,4,0,0,7,0.42857142857142855,0.14285714285714285
213638,3,4,0,0,7,0.42857142857142855,0.14285714285714285
90174,3,4,0,0,7,0.42857142857142855,0.14285714285714285
178597,3,4,0,0,7,0.42857142857142855,0.14285714285714285
274056,6,8,0,0,14,0.42857142857142855,0.14285714285714285
16010,3,4,0,0,7,0.42857142857142855,0.14285714285714285
236595,3,4,0,0,7,0.42857142857142855,0.14285714285714285
183540,3,4,0,0,7,0.42857142857142855,0.14285714285714285
93636,3,4,0,0,7,0.42857142857142855,0.14285714285714285
127168,3,4,0,0,7,0.42857142857142855,0.14285714285714285
220484,3,4,0,0,7,0.42857142857142855,0.14285714285714285
62755,3,4,0,0,7,0.42857142857142855,0.14285714285714285
153865,3,4,0,0,7,0.42857142857142855,0.14285714285714285
75149,12,16,0,0,28,0.42857142857142855,0.14285714285714285
273813,6,8,0,0,14,0.42857142857142855,0.14285714285714285
48911,3,4,0,0,7,0.42857142857142855,0.14285714285714285
44985,3,4,0,0,7,0.42857142857142855,0.14285714285714285
140555,6,8,0,0,14,0.42857142857142855,0.14285714285714285
140294,3,4,0,0,7,0.42857142857142855,0.14285714285714285
35707,2,3,0,2,7,0.2857142857142857,0.14285714285714285
176576,3,4,0,0,7,0.42857142857142855,0.14285714285714285
133905,3,4,0,0,7,0.42857142857142855,0.14285714285714285
235543,3,4,0,0,7,0.42857142857142855,0.14285714285714285
259066,3,4,0,0,7,0.42857142857142855,0.14285714285714285
104569,3,4,0,0,7,0.42857142857142855,0.14285714285714285
127190,6,8,0,0,14,0.42857142857142855,0.14285714285714285
42099,3,4,0,0,7,0.42857142857142855,0.14285714285714285
51100,3,4,0,0,7,0.42857142857142855,0.14285714285714285
22338,3,4,0,0,7,0.42857142857142855,0.14285714285714285
130866,3,4,0,0,7,0.42857142857142855,0.14285714285714285
123095,17,23,0,2,42,0.40476190476190477,0.14285714285714285
245102,3,4,0,0,7,0.42857142857142855,0.14285714285714285
22464,3,4,0,0,7,0.42857142857142855,0.14285714285714285
215180,3,4,0,0,7,0.42857142857142855,0.14285714285714285
206107,3,4,0,0,7,0.42857142857142855,0.14285714285714285
71800,3,4,0,0,7,0.42857142857142855,0.14285714285714285
43852,3,4,0,0,7,0.42857142857142855,0.14285714285714285
260678,3,4,0,0,7,0.42857142857142855,0.14285714285714285
256133,3,4,0,0,7,0.42857142857142855,0.14285714285714285
94818,3,4,0,0,7,0.42857142857142855,0.14285714285714285
109013,3,4,0,0,7,0.42857142857142855,0.14285714285714285
231827,9,12,0,0,21,0.42857142857142855,0.14285714285714285
192176,3,4,0,0,7,0.42857142857142855,0.14285714285714285
249150,3,4,0,0,7,0.42857142857142855,0.14285714285714285
205979,2,3,0,2,7,0.2857142857142857,0.14285714285714285
238057,6,8,0,0,14,0.42857142857142855,0.14285714285714285
135736,3,4,0,0,7,0.42857142857142855,0.14285714285714285
113279,3,4,0,0,7,0.42857142857142855,0.14285714285714285
69042,3,4,0,0,7,0.42857142857142855,0.14285714285714285
150657,3,4,0,0,7,0.42857142857142855,0.14285714285714285
56246,2,3,0,2,7,0.2857142857142857,0.14285714285714285
37311,6,8,0,0,14,0.42857142857142855,0.14285714285714285
30245,3,4,0,0,7,0.42857142857142855,0.14285714285714285
132203,2,3,0,2,7,0.2857142857142857,0.14285714285714285
251560,3,4,0,0,7,0.42857142857142855,0.14285714285714285
40052,3,4,0,0,7,0.42857142857142855,0.14285714285714285
148124,3,4,0,0,7,0.42857142857142855,0.14285714285714285
88993,3,4,0,0,7,0.42857142857142855,0.14285714285714285
112818,3,4,0,0,7,0.42857142857142855,0.14285714285714285
39662,3,4,0,0,7,0.42857142857142855,0.14285714285714285
19145,3,4,0,0,7,0.42857142857142855,0.14285714285714285
93562,3,4,0,0,7,0.42857142857142855,0.14285714285714285
19233,3,4,0,0,7,0.42857142857142855,0.14285714285714285
81848,18,24,0,0,42,0.42857142857142855,0.14285714285714285
28150,3,4,0,0,7,0.42857142857142855,0.14285714285714285
68943,5,7,0,2,14,0.35714285714285715,0.14285714285714285
211360,3,4,0,0,7,0.42857142857142855,0.14285714285714285
80105,2,3,0,2,7,0.2857142857142857,0.14285714285714285
218721,3,4,0,0,7,0.42857142857142855,0.14285714285714285
79186,3,4,0,0,7,0.42857142857142855,0.14285714285714285
186837,5,7,0,2,14,0.35714285714285715,0.14285714285714285
100223,3,4,0,0,7,0.42857142857142855,0.14285714285714285
114893,3,4,0,0,7,0.42857142857142855,0.14285714285714285
22936,3,4,0,0,7,0.42857142857142855,0.14285714285714285
79285,5,7,0,2,14,0.35714285714285715,0.14285714285714285
83252,3,4,0,0,7,0.42857142857142855,0.14285714285714285
233867,3,4,0,0,7,0.42857142857142855,0.14285714285714285
30972,15,20,0,0,35,0.42857142857142855,0.14285714285714285
41760,3,4,0,0,7,0.42857142857142855,0.14285714285714285
54206,3,4,0,0,7,0.42857142857142855,0.14285714285714285
80684,3,4,0,0,7,0.42857142857142855,0.14285714285714285
7913,2,3,0,2,7,0.2857142857142857,0.14285714285714285
169400,3,4,0,0,7,0.42857142857142855,0.14285714285714285
23624,3,4,0,0,7,0.42857142857142855,0.14285714285714285
242499,3,4,0,0,7,0.42857142857142855,0.14285714285714285
57920,3,4,0,0,7,0.42857142857142855,0.14285714285714285
202553,2,3,0,2,7,0.2857142857142857,0.14285714285714285
109783,1,2,0,4,7,0.14285714285714285,0.14285714285714285
132171,6,8,0,0,14,0.42857142857142855,0.14285714285714285
189320,3,4,0,0,7,0.42857142857142855,0.14285714285714285
151262,2,3,0,2,7,0.2857142857142857,0.14285714285714285
270326,3,4,0,0,7,0.42857142857142855,0.14285714285714285
30210,3,4,0,0,7,0.42857142857142855,0.14285714285714285
275638,3,4,0,0,7,0.42857142857142855,0.14285714285714285
127049,6,8,0,0,14,0.42857142857142855,0.14285714285714285
114178,6,8,0,0,14,0.42857142857142855,0.14285714285714285
190479,3,4,0,0,7,0.42857142857142855,0.14285714285714285
244056,3,4,0,0,7,0.42857142857142855,0.14285714285714285
174367,3,4,0,0,7,0.42857142857142855,0.14285714285714285
171295,11,15,1,0,27,0.4074074074074074,0.14814814814814814
38556,11,15,0,1,27,0.4074074074074074,0.14814814814814814
127200,11,15,0,1,27,0.4074074074074074,0.14814814814814814
121170,23,32,0,5,60,0.38333333333333336,0.15
179826,7,10,0,3,20,0.35,0.15
104429,8,11,0,1,20,0.4,0.15
234399,8,11,0,1,20,0.4,0.15
178522,34,46,0,0,80,0.425,0.15
217121,7,12,0,14,33,0.21212121212121213,0.15151515151515152
126726,5,7,0,1,13,0.38461538461538464,0.15384615384615385
111286,5,7,0,1,13,0.38461538461538464,0.15384615384615385
269244,5,7,0,1,13,0.38461538461538464,0.15384615384615385
55607,5,7,0,1,13,0.38461538461538464,0.15384615384615385
28177,19,26,0,0,45,0.4222222222222222,0.15555555555555556
21404,12,17,0,3,32,0.375,0.15625
98904,21,29,0,1,51,0.4117647058823529,0.1568627450980392
86145,15,21,0,2,38,0.39473684210526316,0.15789473684210525
273086,8,11,0,0,19,0.42105263157894735,0.15789473684210525
92861,7,10,0,2,19,0.3684210526315789,0.15789473684210525
78328,8,11,0,0,19,0.42105263157894735,0.15789473684210525
62558,8,11,0,0,19,0.42105263157894735,0.15789473684210525
108285,8,11,0,0,19,0.42105263157894735,0.15789473684210525
259626,8,11,0,0,19,0.42105263157894735,0.15789473684210525
277523,8,11,0,0,19,0.42105263157894735,0.15789473684210525
65258,10,14,0,1,25,0.4,0.16
63394,10,14,1,0,25,0.4,0.16
223431,10,14,0,1,25,0.4,0.16
262902,7,11,0,7,25,0.28,0.16
66680,23,32,0,0,55,0.41818181818181815,0.16363636363636364
162264,2,3,0,1,6,0.3333333333333333,0.16666666666666666
100115,2,3,0,1,6,0.3333333333333333,0.16666666666666666
77052,2,3,0,1,6,0.3333333333333333,0.16666666666666666
191014,5,7,0,0,12,0.4166666666666667,0.16666666666666666
257145,2,3,0,1,6,0.3333333333333333,0.16666666666666666
257028,10,14,0,0,24,0.4166666666666667,0.16666666666666666
256270,2,3,0,1,6,0.3333333333333333,0.16666666666666666
245128,2,3,0,1,6,0.3333333333333333,0.16666666666666666
46145,2,3,0,1,6,0.3333333333333333,0.16666666666666666
35050,5,7,0,0,12,0.4166666666666667,0.16666666666666666
28594,5,7,0,0,12,0.4166666666666667,0.16666666666666666
34075,5,7,0,0,12,0.4166666666666667,0.16666666666666666
54072,2,3,0,1,6,0.3333333333333333,0.16666666666666666
207971,5,7,0,0,12,0.4166666666666667,0.16666666666666666
220122,5,7,0,0,12,0.4166666666666667,0.16666666666666666
256298,0,1,0,5,6,0.0,0.16666666666666666
82511,7,10,0,1,18,0.3888888888888889,0.16666666666666666
257700,5,7,0,0,12,0.4166666666666667,0.16666666666666666
272407,5,7,0,0,12,0.4166666666666667,0.16666666666666666
104362,5,7,0,0,12,0.4166666666666667,0.16666666666666666
30319,2,3,0,1,6,0.3333333333333333,0.16666666666666666
123298,2,3,0,1,6,0.3333333333333333,0.16666666666666666
124259,5,7,0,0,12,0.4166666666666667,0.16666666666666666
21229,2,3,0,1,6,0.3333333333333333,0.16666666666666666
165669,2,3,0,1,6,0.3333333333333333,0.16666666666666666
44925,1,2,0,3,6,0.16666666666666666,0.16666666666666666
52159,5,7,0,0,12,0.4166666666666667,0.16666666666666666
177277,3,5,0,4,12,0.25,0.16666666666666666
17507,1,2,0,3,6,0.16666666666666666,0.16666666666666666
165268,5,7,0,0,12,0.4166666666666667,0.16666666666666666
58612,5,7,0,0,12,0.4166666666666667,0.16666666666666666
59770,2,3,0,1,6,0.3333333333333333,0.16666666666666666
127404,2,3,0,1,6,0.3333333333333333,0.16666666666666666
91576,1,2,0,3,6,0.16666666666666666,0.16666666666666666
277478,2,3,0,1,6,0.3333333333333333,0.16666666666666666
8255,2,3,0,1,6,0.3333333333333333,0.16666666666666666
142817,2,3,0,1,6,0.3333333333333333,0.16666666666666666
219420,2,3,0,1,6,0.3333333333333333,0.16666666666666666
83496,5,7,0,0,12,0.4166666666666667,0.16666666666666666
196775,6,9,0,3,18,0.3333333333333333,0.16666666666666666
221040,5,7,0,0,12,0.4166666666666667,0.16666666666666666
42093,10,14,0,0,24,0.4166666666666667,0.16666666666666666
240224,4,6,0,2,12,0.3333333333333333,0.16666666666666666
273906,1,2,0,3,6,0.16666666666666666,0.16666666666666666
234948,2,3,0,1,6,0.3333333333333333,0.16666666666666666
144925,2,3,0,1,6,0.3333333333333333,0.16666666666666666
25395,5,7,0,0,12,0.4166666666666667,0.16666666666666666
170054,2,3,0,1,6,0.3333333333333333,0.16666666666666666
132930,9,13,0,2,24,0.375,0.16666666666666666
187762,15,21,0,0,36,0.4166666666666667,0.16666666666666666
188280,2,3,0,1,6,0.3333333333333333,0.16666666666666666
51559,1,2,0,3,6,0.16666666666666666,0.16666666666666666
70189,2,3,0,1,6,0.3333333333333333,0.16666666666666666
262311,2,3,0,1,6,0.3333333333333333,0.16666666666666666
109461,7,10,0,1,18,0.3888888888888889,0.16666666666666666
12154,5,7,0,0,12,0.4166666666666667,0.16666666666666666
41676,2,3,0,1,6,0.3333333333333333,0.16666666666666666
248547,1,2,0,3,6,0.16666666666666666,0.16666666666666666
171389,1,2,0,3,6,0.16666666666666666,0.16666666666666666
233480,2,3,0,1,6,0.3333333333333333,0.16666666666666666
24878,2,3,0,1,6,0.3333333333333333,0.16666666666666666
131046,10,14,0,0,24,0.4166666666666667,0.16666666666666666
40888,5,7,0,0,12,0.4166666666666667,0.16666666666666666
16383,2,3,0,1,6,0.3333333333333333,0.16666666666666666
30607,2,3,0,1,6,0.3333333333333333,0.16666666666666666
21912,2,3,0,1,6,0.3333333333333333,0.16666666666666666
4938,5,7,0,0,12,0.4166666666666667,0.16666666666666666
37573,2,3,0,1,6,0.3333333333333333,0.16666666666666666
90653,5,7,0,0,12,0.4166666666666667,0.16666666666666666
105536,5,7,0,0,12,0.4166666666666667,0.16666666666666666
224159,5,7,0,0,12,0.4166666666666667,0.16666666666666666
174834,2,3,0,1,6,0.3333333333333333,0.16666666666666666
132392,5,7,0,0,12,0.4166666666666667,0.16666666666666666
65769,2,3,0,1,6,0.3333333333333333,0.16666666666666666
98686,12,17,0,1,30,0.4,0.16666666666666666
219924,4,6,0,2,12,0.3333333333333333,0.16666666666666666
3346,7,10,0,1,18,0.3888888888888889,0.16666666666666666
249128,0,1,0,5,6,0.0,0.16666666666666666
26664,0,1,0,5,6,0.0,0.16666666666666666
205992,2,3,0,1,6,0.3333333333333333,0.16666666666666666
270401,2,3,0,1,6,0.3333333333333333,0.16666666666666666
268032,14,20,0,1,35,0.4,0.17142857142857143
144038,14,20,0,1,35,0.4,0.17142857142857143
160681,9,13,0,1,23,0.391304347826087,0.17391304347826086
259006,9,13,0,1,23,0.391304347826087,0.17391304347826086
100088,8,12,0,3,23,0.34782608695652173,0.17391304347826086
170947,9,13,0,1,23,0.391304347826087,0.17391304347826086
240567,34,49,0,3,86,0.3953488372093023,0.1744186046511628
78448,16,23,0,1,40,0.4,0.175
244286,7,10,0,0,17,0.4117647058823529,0.17647058823529413
60858,6,9,0,2,17,0.35294117647058826,0.17647058823529413
148199,6,9,0,2,17,0.35294117647058826,0.17647058823529413
199772,7,10,0,0,17,0.4117647058823529,0.17647058823529413
163319,6,9,0,2,17,0.35294117647058826,0.17647058823529413
129851,6,9,0,2,17,0.35294117647058826,0.17647058823529413
184401,11,16,0,1,28,0.39285714285714285,0.17857142857142858
9856,10,15,0,3,28,0.35714285714285715,0.17857142857142858
85426,15,22,0,2,39,0.38461538461538464,0.1794871794871795
136205,16,23,0,0,39,0.41025641025641024,0.1794871794871795
236058,20,29,0,1,50,0.4,0.18
40415,9,13,0,0,22,0.4090909090909091,0.18181818181818182
211288,4,6,0,1,11,0.36363636363636365,0.18181818181818182
179147,4,6,0,1,11,0.36363636363636365,0.18181818181818182
86033,1,3,0,7,11,0.09090909090909091,0.18181818181818182
179075,4,6,0,1,11,0.36363636363636365,0.18181818181818182
93565,9,13,0,0,22,0.4090909090909091,0.18181818181818182
243984,4,6,0,1,11,0.36363636363636365,0.18181818181818182
95301,2,4,0,5,11,0.18181818181818182,0.18181818181818182
114279,3,5,0,3,11,0.2727272727272727,0.18181818181818182
23771,4,6,0,1,11,0.36363636363636365,0.18181818181818182
30994,13,19,0,1,33,0.3939393939393939,0.18181818181818182
97208,4,6,0,1,11,0.36363636363636365,0.18181818181818182
182969,9,13,0,0,22,0.4090909090909091,0.18181818181818182
7210,4,6,0,1,11,0.36363636363636365,0.18181818181818182
81088,4,6,0,1,11,0.36363636363636365,0.18181818181818182
146932,9,13,0,0,22,0.4090909090909091,0.18181818181818182
59172,27,42,0,13,82,0.32926829268292684,0.18292682926829268
101876,24,35,0,1,60,0.4,0.18333333333333332
184532,19,28,0,1,48,0.3958333333333333,0.1875
99996,4,7,0,5,16,0.25,0.1875
255218,5,8,0,3,16,0.3125,0.1875
225938,6,9,0,1,16,0.375,0.1875
71712,6,9,0,1,16,0.375,0.1875
123825,12,19,0,6,37,0.32432432432432434,0.1891891891891892
126604,14,21,0,2,37,0.3783783783783784,0.1891891891891892
143792,8,12,0,1,21,0.38095238095238093,0.19047619047619047
18067,7,11,0,3,21,0.3333333333333333,0.19047619047619047
196047,8,12,0,1,21,0.38095238095238093,0.19047619047619047
108005,12,18,0,1,31,0.3870967741935484,0.1935483870967742
237271,14,21,0,1,36,0.3888888888888889,0.19444444444444445
224764,30,45,1,1,77,0.38961038961038963,0.19480519480519481
67840,28,43,0,5,76,0.3684210526315789,0.19736842105263158
238179,2,3,0,0,5,0.4,0.2
111733,2,3,0,0,5,0.4,0.2
170155,1,2,0,2,5,0.2,0.2
149231,4,6,0,0,10,0.4,0.2
30968,2,3,0,0,5,0.4,0.2
64220,2,3,0,0,5,0.4,0.2
10699,2,3,0,0,5,0.4,0.2
200772,2,3,0,0,5,0.4,0.2
170372,2,3,0,0,5,0.4,0.2
170401,2,3,0,0,5,0.4,0.2
120873,4,6,0,0,10,0.4,0.2
93770,1,2,0,2,5,0.2,0.2
138849,1,2,0,2,5,0.2,0.2
28139,2,3,0,0,5,0.4,0.2
214212,4,6,0,0,10,0.4,0.2
148934,4,6,0,0,10,0.4,0.2
187463,1,2,0,2,5,0.2,0.2
264300,2,3,0,0,5,0.4,0.2
69023,2,3,0,0,5,0.4,0.2
242544,2,3,0,0,5,0.4,0.2
64271,2,3,0,0,5,0.4,0.2
93615,2,3,0,0,5,0.4,0.2
217512,2,3,0,0,5,0.4,0.2
270226,2,3,0,0,5,0.4,0.2
55655,2,3,0,0,5,0.4,0.2
200607,2,3,0,0,5,0.4,0.2
233143,2,3,0,0,5,0.4,0.2
150894,2,3,0,0,5,0.4,0.2
49313,2,3,0,0,5,0.4,0.2
22695,2,3,0,0,5,0.4,0.2
272705,1,2,0,2,5,0.2,0.2
152605,2,3,0,0,5,0.4,0.2
250223,2,3,0,0,5,0.4,0.2
250006,2,3,0,0,5,0.4,0.2
233976,4,6,0,0,10,0.4,0.2
198507,2,3,0,0,5,0.4,0.2
137118,6,9,0,0,15,0.4,0.2
109014,2,3,0,0,5,0.4,0.2
50539,1,2,0,2,5,0.2,0.2
88574,2,3,0,0,5,0.4,0.2
271587,2,3,0,0,5,0.4,0.2
69808,1,2,0,2,5,0.2,0.2
138045,1,2,0,2,5,0.2,0.2
138189,4,6,0,0,10,0.4,0.2
151738,2,3,0,0,5,0.4,0.2
151643,2,3,0,0,5,0.4,0.2
24052,2,3,0,0,5,0.4,0.2
240272,2,3,0,0,5,0.4,0.2
249361,2,3,0,0,5,0.4,0.2
227654,2,3,0,0,5,0.4,0.2
64075,2,3,0,0,5,0.4,0.2
24427,2,3,0,0,5,0.4,0.2
223768,2,3,0,0,5,0.4,0.2
110609,2,3,0,0,5,0.4,0.2
270723,2,3,0,0,5,0.4,0.2
24525,4,6,0,0,10,0.4,0.2
93513,2,3,0,0,5,0.4,0.2
148344,2,3,0,0,5,0.4,0.2
184223,2,3,0,0,5,0.4,0.2
198355,2,3,0,0,5,0.4,0.2
268540,4,6,0,0,10,0.4,0.2
41985,2,3,0,0,5,0.4,0.2
66323,6,9,0,0,15,0.4,0.2
117738,1,2,0,2,5,0.2,0.2
26756,2,3,0,0,5,0.4,0.2
92498,8,12,0,0,20,0.4,0.2
185384,6,9,0,0,15,0.4,0.2
266940,2,3,0,0,5,0.4,0.2
203598,4,6,0,0,10,0.4,0.2
91425,1,2,0,2,5,0.2,0.2
92316,2,3,0,0,5,0.4,0.2
144241,1,2,0,2,5,0.2,0.2
220399,2,3,0,0,5,0.4,0.2
117683,1,2,0,2,5,0.2,0.2
80929,2,3,0,0,5,0.4,0.2
144017,2,3,0,0,5,0.4,0.2
247518,2,3,0,0,5,0.4,0.2
26538,2,3,0,0,5,0.4,0.2
116313,2,3,0,0,5,0.4,0.2
173190,2,3,0,0,5,0.4,0.2
66487,4,6,0,0,10,0.4,0.2
116433,2,3,0,0,5,0.4,0.2
66518,4,6,0,0,10,0.4,0.2
204452,2,3,0,0,5,0.4,0.2
267453,2,3,0,0,5,0.4,0.2
142801,2,3,0,0,5,0.4,0.2
267249,4,6,0,0,10,0.4,0.2
205919,6,9,0,0,15,0.4,0.2
118101,2,3,0,0,5,0.4,0.2
230626,2,3,0,0,5,0.4,0.2
119963,2,3,0,0,5,0.4,0.2
264985,2,3,0,0,5,0.4,0.2
147851,2,3,0,0,5,0.4,0.2
119749,2,3,0,0,5,0.4,0.2
205520,2,3,0,0,5,0.4,0.2
174738,2,3,0,0,5,0.4,0.2
205197,4,6,0,0,10,0.4,0.2
25109,2,3,0,0,5,0.4,0.2
228181,2,3,0,0,5,0.4,0.2
269273,5,8,0,2,15,0.3333333333333333,0.2
80453,4,6,0,0,10,0.4,0.2
141201,2,3,0,0,5,0.4,0.2
7841,6,9,0,0,15,0.4,0.2
171096,2,3,0,0,5,0.4,0.2
146530,4,6,0,0,10,0.4,0.2
231252,2,3,0,0,5,0.4,0.2
81333,2,3,0,0,5,0.4,0.2
202353,4,6,0,0,10,0.4,0.2
32516,3,5,0,2,10,0.3,0.2
266268,12,18,0,0,30,0.4,0.2
268704,2,3,0,0,5,0.4,0.2
141704,2,3,0,0,5,0.4,0.2
114662,2,3,0,0,5,0.4,0.2
229177,2,3,0,0,5,0.4,0.2
118344,2,3,0,0,5,0.4,0.2
115180,2,3,0,0,5,0.4,0.2
8188,2,3,0,0,5,0.4,0.2
216057,1,2,0,2,5,0.2,0.2
273089,2,3,0,0,5,0.4,0.2
117255,2,3,0,0,5,0.4,0.2
210174,2,3,0,0,5,0.4,0.2
29497,4,6,0,0,10,0.4,0.2
275476,2,3,0,0,5,0.4,0.2
99314,2,3,0,0,5,0.4,0.2
275383,2,3,0,0,5,0.4,0.2
103251,2,3,0,0,5,0.4,0.2
132624,2,3,0,0,5,0.4,0.2
20627,2,3,0,0,5,0.4,0.2
20629,2,3,0,0,5,0.4,0.2
275228,2,3,0,0,5,0.4,0.2
17159,2,3,0,0,5,0.4,0.2
219149,2,3,0,0,5,0.4,0.2
219209,2,3,0,0,5,0.4,0.2
29094,2,3,0,0,5,0.4,0.2
165512,2,3,0,0,5,0.4,0.2
77816,2,3,0,0,5,0.4,0.2
275220,3,5,1,1,10,0.3,0.2
75013,2,3,0,0,5,0.4,0.2
211944,2,3,0,0,5,0.4,0.2
160381,2,3,0,0,5,0.4,0.2
28945,2,3,0,0,5,0.4,0.2
74689,2,3,0,0,5,0.4,0.2
194027,2,3,0,0,5,0.4,0.2
28731,2,3,0,0,5,0.4,0.2
160180,2,3,0,0,5,0.4,0.2
58151,2,3,0,0,5,0.4,0.2
256889,2,3,0,0,5,0.4,0.2
223325,2,3,0,0,5,0.4,0.2
127171,2,3,0,0,5,0.4,0.2
192727,2,3,0,0,5,0.4,0.2
253771,4,6,0,0,10,0.4,0.2
129389,2,3,0,0,5,0.4,0.2
76741,2,3,0,0,5,0.4,0.2
221672,1,2,0,2,5,0.2,0.2
163329,2,3,0,0,5,0.4,0.2
253563,2,3,0,0,5,0.4,0.2
19107,2,3,0,0,5,0.4,0.2
58497,2,3,0,0,5,0.4,0.2
129494,0,1,0,4,5,0.0,0.2
211152,5,8,0,2,15,0.3333333333333333,0.2
100644,9,15,0,6,30,0.3,0.2
76812,2,3,0,0,5,0.4,0.2
179739,6,9,0,0,15,0.4,0.2
210921,2,3,0,0,5,0.4,0.2
18176,2,3,0,0,5,0.4,0.2
162662,2,3,0,0,5,0.4,0.2
219921,2,3,0,0,5,0.4,0.2
164105,2,3,0,0,5,0.4,0.2
254751,2,3,0,0,5,0.4,0.2
76105,2,3,0,0,5,0.4,0.2
100066,2,3,0,0,5,0.4,0.2
130543,2,3,0,0,5,0.4,0.2
276167,2,3,0,0,5,0.4,0.2
179843,2,3,0,0,5,0.4,0.2
277439,2,3,0,0,5,0.4,0.2
36715,11,17,0,2,30,0.36666666666666664,0.2
36357,2,3,0,0,5,0.4,0.2
209625,2,3,0,0,5,0.4,0.2
74487,2,3,0,0,5,0.4,0.2
239670,2,3,0,0,5,0.4,0.2
259660,2,3,0,0,5,0.4,0.2
236025,2,3,0,0,5,0.4,0.2
37817,2,3,0,0,5,0.4,0.2
96054,4,6,0,0,10,0.4,0.2
235888,2,3,0,0,5,0.4,0.2
177590,10,15,0,0,25,0.4,0.2
107109,2,3,0,0,5,0.4,0.2
124732,2,3,0,0,5,0.4,0.2
834,0,1,0,4,5,0.0,0.2
46389,2,3,0,0,5,0.4,0.2
235671,2,3,0,0,5,0.4,0.2
87688,2,3,0,0,5,0.4,0.2
60253,2,3,0,0,5,0.4,0.2
84820,1,2,0,2,5,0.2,0.2
124207,2,3,0,0,5,0.4,0.2
154269,2,3,0,0,5,0.4,0.2
208376,2,3,0,0,5,0.4,0.2
61668,2,3,0,0,5,0.4,0.2
45444,2,3,0,0,5,0.4,0.2
197425,2,3,0,0,5,0.4,0.2
57449,2,3,0,0,5,0.4,0.2
38544,4,6,0,0,10,0.4,0.2
250461,2,3,0,0,5,0.4,0.2
123724,2,3,0,0,5,0.4,0.2
28492,2,3,0,0,5,0.4,0.2
250456,2,3,0,0,5,0.4,0.2
154487,2,3,0,0,5,0.4,0.2
207686,2,3,0,0,5,0.4,0.2
178079,6,9,0,0,15,0.4,0.2
55961,2,3,0,0,5,0.4,0.2
104759,2,3,0,0,5,0.4,0.2
30385,2,3,0,0,5,0.4,0.2
125396,2,3,0,0,5,0.4,0.2
194614,6,9,0,0,15,0.4,0.2
104883,2,3,0,0,5,0.4,0.2
159044,2,3,0,0,5,0.4,0.2
243,6,9,0,0,15,0.4,0.2
258275,2,3,0,0,5,0.4,0.2
225378,2,3,0,0,5,0.4,0.2
158361,2,3,0,0,5,0.4,0.2
21660,2,3,0,0,5,0.4,0.2
158104,2,3,0,0,5,0.4,0.2
105572,2,3,0,0,5,0.4,0.2
251398,2,3,0,0,5,0.4,0.2
106078,2,3,0,0,5,0.4,0.2
251391,2,3,0,0,5,0.4,0.2
167176,2,3,0,0,5,0.4,0.2
37571,2,3,0,0,5,0.4,0.2
106282,2,3,0,0,5,0.4,0.2
446,2,3,0,0,5,0.4,0.2
156534,1,2,0,2,5,0.2,0.2
106553,2,3,0,0,5,0.4,0.2
213369,2,3,0,0,5,0.4,0.2
189005,2,3,0,0,5,0.4,0.2
259378,4,6,0,0,10,0.4,0.2
96444,2,3,0,0,5,0.4,0.2
91685,2,3,0,0,5,0.4,0.2
78834,23,37,1,8,69,0.3333333333333333,0.2028985507246377
254,10,16,0,3,29,0.3448275862068966,0.20689655172413793
67591,9,15,0,5,29,0.3103448275862069,0.20689655172413793
126736,18,28,0,2,48,0.375,0.20833333333333334
153797,9,14,0,1,24,0.375,0.20833333333333334
60050,7,11,1,0,19,0.3684210526315789,0.21052631578947367
183061,7,11,0,1,19,0.3684210526315789,0.21052631578947367
207825,7,11,1,0,19,0.3684210526315789,0.21052631578947367
36327,7,11,0,1,19,0.3684210526315789,0.21052631578947367
52917,19,30,0,3,52,0.36538461538461536,0.21153846153846154
205383,5,8,0,1,14,0.35714285714285715,0.21428571428571427
251606,5,8,0,1,14,0.35714285714285715,0.21428571428571427
264996,5,8,0,1,14,0.35714285714285715,0.21428571428571427
14387,5,8,0,1,14,0.35714285714285715,0.21428571428571427
38660,5,8,0,1,14,0.35714285714285715,0.21428571428571427
32721,6,12,0,10,28,0.21428571428571427,0.21428571428571427
147451,13,22,0,7,42,0.30952380952380953,0.21428571428571427
201141,3,6,0,5,14,0.21428571428571427,0.21428571428571427
232964,11,17,0,0,28,0.39285714285714285,0.21428571428571427
183963,5,8,0,1,14,0.35714285714285715,0.21428571428571427
203764,11,17,0,0,28,0.39285714285714285,0.21428571428571427
14667,5,8,0,1,14,0.35714285714285715,0.21428571428571427
6772,4,7,0,3,14,0.2857142857142857,0.21428571428571427
155014,14,22,0,1,37,0.3783783783783784,0.21621621621621623
200978,3,5,0,1,9,0.3333333333333333,0.2222222222222222
187574,7,11,0,0,18,0.3888888888888889,0.2222222222222222
93179,13,21,0,2,36,0.3611111111111111,0.2222222222222222
256407,7,11,0,0,18,0.3888888888888889,0.2222222222222222
237474,3,5,0,1,9,0.3333333333333333,0.2222222222222222
27947,3,5,0,1,9,0.3333333333333333,0.2222222222222222
3719,2,4,0,3,9,0.2222222222222222,0.2222222222222222
193412,3,5,0,1,9,0.3333333333333333,0.2222222222222222
267538,3,5,0,1,9,0.3333333333333333,0.2222222222222222
69709,3,5,0,1,9,0.3333333333333333,0.2222222222222222
136071,7,11,0,0,18,0.3888888888888889,0.2222222222222222
3167,7,11,0,0,18,0.3888888888888889,0.2222222222222222
643,1,3,0,5,9,0.1111111111111111,0.2222222222222222
228727,4,8,0,6,18,0.2222222222222222,0.2222222222222222
20703,3,5,0,1,9,0.3333333333333333,0.2222222222222222
171846,2,4,0,3,9,0.2222222222222222,0.2222222222222222
116537,3,5,0,1,9,0.3333333333333333,0.2222222222222222
76173,7,11,0,0,18,0.3888888888888889,0.2222222222222222
31226,3,5,0,1,9,0.3333333333333333,0.2222222222222222
116521,3,5,0,1,9,0.3333333333333333,0.2222222222222222
49155,2,4,0,3,9,0.2222222222222222,0.2222222222222222
86959,3,5,1,0,9,0.3333333333333333,0.2222222222222222
212568,3,5,0,1,9,0.3333333333333333,0.2222222222222222
21356,7,11,0,0,18,0.3888888888888889,0.2222222222222222
58062,3,5,0,1,9,0.3333333333333333,0.2222222222222222
210485,39,64,0,9,112,0.3482142857142857,0.22321428571428573
251613,8,13,0,1,22,0.36363636363636365,0.22727272727272727
120598,8,13,0,1,22,0.36363636363636365,0.22727272727272727
87964,8,13,0,1,22,0.36363636363636365,0.22727272727272727
93092,13,21,0,1,35,0.37142857142857144,0.22857142857142856
154469,17,28,0,3,48,0.3541666666666667,0.22916666666666666
124487,22,36,0,3,61,0.36065573770491804,0.22950819672131148
60319,5,8,0,0,13,0.38461538461538464,0.23076923076923078
132909,5,8,0,0,13,0.38461538461538464,0.23076923076923078
249695,5,8,0,0,13,0.38461538461538464,0.23076923076923078
175636,5,8,0,0,13,0.38461538461538464,0.23076923076923078
47128,5,8,0,0,13,0.38461538461538464,0.23076923076923078
203075,9,15,0,2,26,0.34615384615384615,0.23076923076923078
10949,4,7,0,2,13,0.3076923076923077,0.23076923076923078
25131,5,8,0,0,13,0.38461538461538464,0.23076923076923078
66387,5,8,0,0,13,0.38461538461538464,0.23076923076923078
5539,5,8,0,0,13,0.38461538461538464,0.23076923076923078
130950,5,8,0,0,13,0.38461538461538464,0.23076923076923078
64436,10,17,0,3,30,0.3333333333333333,0.23333333333333334
34300,11,18,0,1,30,0.36666666666666664,0.23333333333333334
266840,13,21,0,0,34,0.38235294117647056,0.23529411764705882
162376,6,10,0,1,17,0.35294117647058826,0.23529411764705882
165806,4,8,0,5,17,0.23529411764705882,0.23529411764705882
213628,6,10,0,1,17,0.35294117647058826,0.23529411764705882
266865,20,33,0,2,55,0.36363636363636365,0.23636363636363636
241204,7,12,0,2,21,0.3333333333333333,0.23809523809523808
248850,8,13,0,0,21,0.38095238095238093,0.23809523809523808
224809,14,24,0,4,42,0.3333333333333333,0.23809523809523808
53729,7,12,0,2,21,0.3333333333333333,0.23809523809523808
99720,8,13,0,0,21,0.38095238095238093,0.23809523809523808
3373,8,13,0,0,21,0.38095238095238093,0.23809523809523808
232959,7,12,0,2,21,0.3333333333333333,0.23809523809523808
259629,19,31,0,0,50,0.38,0.24
131154,9,15,0,1,25,0.36,0.24
87555,18,31,1,4,54,0.3333333333333333,0.24074074074074073
170634,11,18,0,0,29,0.3793103448275862,0.2413793103448276
54335,11,18,0,0,29,0.3793103448275862,0.2413793103448276
7158,12,20,0,1,33,0.36363636363636365,0.24242424242424243
44893,15,25,0,1,41,0.36585365853658536,0.24390243902439024
109574,15,26,0,4,45,0.3333333333333333,0.24444444444444444
165319,36,60,0,2,98,0.3673469387755102,0.24489795918367346
103935,3,5,0,0,8,0.375,0.25
76532,3,5,0,0,8,0.375,0.25
129393,3,5,0,0,8,0.375,0.25
76351,4,7,0,1,12,0.3333333333333333,0.25
159977,3,5,0,0,8,0.375,0.25
76223,14,24,0,2,40,0.35,0.25
221655,6,10,0,0,16,0.375,0.25
216670,6,10,0,0,16,0.375,0.25
126240,4,7,0,1,12,0.3333333333333333,0.25
76168,6,10,0,0,16,0.375,0.25
58911,3,5,0,0,8,0.375,0.25
192353,4,7,0,1,12,0.3333333333333333,0.25
181714,3,5,0,0,8,0.375,0.25
162155,4,7,0,1,12,0.3333333333333333,0.25
237898,4,7,0,1,12,0.3333333333333333,0.25
256402,8,14,0,2,24,0.3333333333333333,0.25
128014,3,5,0,0,8,0.375,0.25
77307,3,5,0,0,8,0.375,0.25
47512,3,5,0,0,8,0.375,0.25
127564,3,5,0,0,8,0.375,0.25
256167,7,12,0,1,20,0.35,0.25
179741,3,5,0,0,8,0.375,0.25
103496,3,5,0,0,8,0.375,0.25
143163,13,22,0,1,36,0.3611111111111111,0.25
152942,3,5,0,0,8,0.375,0.25
50204,3,5,0,0,8,0.375,0.25
11362,3,5,0,0,8,0.375,0.25
50612,3,5,0,0,8,0.375,0.25
44467,3,5,0,0,8,0.375,0.25
9177,1,3,0,4,8,0.125,0.25
232106,9,15,0,0,24,0.375,0.25
89874,3,5,0,0,8,0.375,0.25
140036,4,9,0,7,20,0.2,0.25
231857,11,19,0,2,32,0.34375,0.25
90467,3,5,0,0,8,0.375,0.25
11638,3,5,0,0,8,0.375,0.25
265918,3,5,0,0,8,0.375,0.25
241265,3,5,0,0,8,0.375,0.25
202564,2,5,0,5,12,0.16666666666666666,0.25
32034,3,5,0,0,8,0.375,0.25
81045,3,5,0,0,8,0.375,0.25
26583,3,5,0,0,8,0.375,0.25
229922,3,5,0,0,8,0.375,0.25
185296,3,5,0,0,8,0.375,0.25
6115,3,5,0,0,8,0.375,0.25
267830,6,10,0,0,16,0.375,0.25
163430,3,5,0,0,8,0.375,0.25
209563,3,5,0,0,8,0.375,0.25
122867,3,5,0,0,8,0.375,0.25
12272,2,5,0,5,12,0.16666666666666666,0.25
52293,2,4,0,2,8,0.25,0.25
105937,10,17,0,1,28,0.35714285714285715,0.25
96880,3,5,0,0,8,0.375,0.25
106849,11,19,0,2,32,0.34375,0.25
213839,3,5,0,0,8,0.375,0.25
274308,13,22,0,1,36,0.3611111111111111,0.25
196191,2,5,0,5,12,0.16666666666666666,0.25
154944,4,7,0,1,12,0.3333333333333333,0.25
37968,2,4,0,2,8,0.25,0.25
245534,4,7,0,1,12,0.3333333333333333,0.25
135609,7,12,0,1,20,0.35,0.25
70649,5,9,0,2,16,0.3125,0.25
45391,3,5,0,0,8,0.375,0.25
123468,2,4,0,2,8,0.25,0.25
220931,3,5,0,0,8,0.375,0.25
169006,3,5,0,0,8,0.375,0.25
38718,3,5,0,0,8,0.375,0.25
226987,3,5,0,0,8,0.375,0.25
45340,3,5,0,0,8,0.375,0.25
62542,7,12,0,1,20,0.35,0.25
197000,3,5,0,0,8,0.375,0.25
180957,5,9,0,2,16,0.3125,0.25
211426,26,45,0,4,75,0.3466666666666667,0.25333333333333335
123981,25,44,1,4,74,0.33783783783783783,0.25675675675675674
123094,12,21,0,2,35,0.34285714285714286,0.2571428571428571
150896,9,16,0,2,27,0.3333333333333333,0.25925925925925924
29209,10,17,0,0,27,0.37037037037037035,0.25925925925925924
105058,8,14,0,1,23,0.34782608695652173,0.2608695652173913
54622,8,14,0,1,23,0.34782608695652173,0.2608695652173913
150661,8,14,0,1,23,0.34782608695652173,0.2608695652173913
189139,8,14,0,1,23,0.34782608695652173,0.2608695652173913
224646,13,24,0,5,42,0.30952380952380953,0.2619047619047619
198930,6,11,1,1,19,0.3157894736842105,0.2631578947368421
92853,4,9,0,6,19,0.21052631578947367,0.2631578947368421
41589,7,12,0,0,19,0.3684210526315789,0.2631578947368421
206423,7,12,0,0,19,0.3684210526315789,0.2631578947368421
192211,4,8,0,3,15,0.26666666666666666,0.26666666666666666
129690,5,9,0,1,15,0.3333333333333333,0.26666666666666666
104113,11,19,0,0,30,0.36666666666666664,0.26666666666666666
271176,11,19,0,0,30,0.36666666666666664,0.26666666666666666
68156,5,9,0,1,15,0.3333333333333333,0.26666666666666666
243360,9,16,0,1,26,0.34615384615384615,0.2692307692307692
187145,27,48,0,3,78,0.34615384615384615,0.2692307692307692
139359,9,16,0,1,26,0.34615384615384615,0.2692307692307692
114446,4,11,0,11,26,0.15384615384615385,0.2692307692307692
36907,22,39,0,2,63,0.3492063492063492,0.2698412698412698
274004,15,28,0,5,48,0.3125,0.2708333333333333
268300,21,37,0,1,59,0.3559322033898305,0.2711864406779661
237264,4,7,0,0,11,0.36363636363636365,0.2727272727272727
74026,8,14,0,0,22,0.36363636363636365,0.2727272727272727
183088,4,7,0,0,11,0.36363636363636365,0.2727272727272727
3923,4,7,0,0,11,0.36363636363636365,0.2727272727272727
76482,4,7,0,0,11,0.36363636363636365,0.2727272727272727
170527,4,7,0,0,11,0.36363636363636365,0.2727272727272727
87351,4,7,0,0,11,0.36363636363636365,0.2727272727272727
8801,4,7,0,0,11,0.36363636363636365,0.2727272727272727
200009,3,6,1,1,11,0.2727272727272727,0.2727272727272727
162311,4,7,0,0,11,0.36363636363636365,0.2727272727272727
172203,4,7,0,0,11,0.36363636363636365,0.2727272727272727
222050,5,11,0,6,22,0.22727272727272727,0.2727272727272727
1025,3,6,0,2,11,0.2727272727272727,0.2727272727272727
98026,3,6,0,2,11,0.2727272727272727,0.2727272727272727
239692,4,7,0,0,11,0.36363636363636365,0.2727272727272727
6566,4,7,0,0,11,0.36363636363636365,0.2727272727272727
228789,3,6,0,2,11,0.2727272727272727,0.2727272727272727
14638,3,6,0,2,11,0.2727272727272727,0.2727272727272727
129503,4,7,0,0,11,0.36363636363636365,0.2727272727272727
13850,9,18,0,6,33,0.2727272727272727,0.2727272727272727
212260,4,7,0,0,11,0.36363636363636365,0.2727272727272727
112401,3,6,0,2,11,0.2727272727272727,0.2727272727272727
86969,4,7,0,0,11,0.36363636363636365,0.2727272727272727
223566,7,13,0,2,22,0.3181818181818182,0.2727272727272727
68568,4,7,0,0,11,0.36363636363636365,0.2727272727272727
268544,4,7,0,0,11,0.36363636363636365,0.2727272727272727
39219,4,7,0,0,11,0.36363636363636365,0.2727272727272727
114813,4,7,0,0,11,0.36363636363636365,0.2727272727272727
79942,3,6,0,2,11,0.2727272727272727,0.2727272727272727
209160,10,18,0,1,29,0.3448275862068966,0.27586206896551724
131622,6,11,0,1,18,0.3333333333333333,0.2777777777777778
143715,6,11,0,1,18,0.3333333333333333,0.2777777777777778
84479,6,11,0,1,18,0.3333333333333333,0.2777777777777778
208141,6,11,0,1,18,0.3333333333333333,0.2777777777777778
22818,6,11,0,1,18,0.3333333333333333,0.2777777777777778
59727,6,11,1,0,18,0.3333333333333333,0.2777777777777778
124942,6,11,0,1,18,0.3333333333333333,0.2777777777777778
75081,6,11,0,1,18,0.3333333333333333,0.2777777777777778
184365,6,11,0,1,18,0.3333333333333333,0.2777777777777778
85367,6,11,0,1,18,0.3333333333333333,0.2777777777777778
146348,13,24,0,2,39,0.3333333333333333,0.28205128205128205
101305,16,29,0,1,46,0.34782608695652173,0.2826086956521739
26371,4,8,0,2,14,0.2857142857142857,0.2857142857142857
11601,9,17,0,2,28,0.32142857142857145,0.2857142857142857
271375,2,4,0,1,7,0.2857142857142857,0.2857142857142857
228206,1,3,0,3,7,0.14285714285714285,0.2857142857142857
205281,2,4,0,1,7,0.2857142857142857,0.2857142857142857
104812,5,9,0,0,14,0.35714285714285715,0.2857142857142857
151608,3,7,0,4,14,0.21428571428571427,0.2857142857142857
61888,2,4,0,1,7,0.2857142857142857,0.2857142857142857
108773,2,4,0,1,7,0.2857142857142857,0.2857142857142857
94023,1,5,0,8,14,0.07142857142857142,0.2857142857142857
139827,7,13,0,1,21,0.3333333333333333,0.2857142857142857
240403,12,22,0,1,35,0.34285714285714286,0.2857142857142857
36157,2,4,0,1,7,0.2857142857142857,0.2857142857142857
105335,1,3,0,3,7,0.14285714285714285,0.2857142857142857
78564,2,4,0,1,7,0.2857142857142857,0.2857142857142857
106294,5,9,0,0,14,0.35714285714285715,0.2857142857142857
14698,2,4,0,1,7,0.2857142857142857,0.2857142857142857
21540,2,4,0,1,7,0.2857142857142857,0.2857142857142857
119631,2,4,0,1,7,0.2857142857142857,0.2857142857142857
132290,1,3,0,3,7,0.14285714285714285,0.2857142857142857
239161,2,4,0,1,7,0.2857142857142857,0.2857142857142857
126985,2,4,0,1,7,0.2857142857142857,0.2857142857142857
76102,5,9,0,0,14,0.35714285714285715,0.2857142857142857
243942,5,9,0,0,14,0.35714285714285715,0.2857142857142857
42730,2,4,0,1,7,0.2857142857142857,0.2857142857142857
223253,1,3,0,3,7,0.14285714285714285,0.2857142857142857
148239,2,4,0,1,7,0.2857142857142857,0.2857142857142857
180586,2,4,0,1,7,0.2857142857142857,0.2857142857142857
117539,2,4,0,1,7,0.2857142857142857,0.2857142857142857
276071,2,4,0,1,7,0.2857142857142857,0.2857142857142857
244517,2,4,0,1,7,0.2857142857142857,0.2857142857142857
145861,2,4,0,1,7,0.2857142857142857,0.2857142857142857
75089,5,9,0,0,14,0.35714285714285715,0.2857142857142857
116090,2,4,0,1,7,0.2857142857142857,0.2857142857142857
118484,5,9,0,0,14,0.35714285714285715,0.2857142857142857
267648,2,4,0,1,7,0.2857142857142857,0.2857142857142857
266650,5,9,0,0,14,0.35714285714285715,0.2857142857142857
83239,2,4,0,1,7,0.2857142857142857,0.2857142857142857
41177,5,9,0,0,14,0.35714285714285715,0.2857142857142857
66942,17,32,0,3,52,0.3269230769230769,0.28846153846153844
32440,14,27,0,4,45,0.3111111111111111,0.28888888888888886
224349,23,43,0,3,69,0.3333333333333333,0.2898550724637681
105054,10,19,0,2,31,0.3225806451612903,0.2903225806451613
52350,11,20,0,0,31,0.3548387096774194,0.2903225806451613
68185,7,14,0,3,24,0.2916666666666667,0.2916666666666667
94787,6,11,0,0,17,0.35294117647058826,0.29411764705882354
247060,6,11,0,0,17,0.35294117647058826,0.29411764705882354
41455,12,23,0,2,37,0.32432432432432434,0.2972972972972973
22521,7,13,0,0,20,0.35,0.3
39513,3,6,0,1,10,0.3,0.3
270906,3,6,0,1,10,0.3,0.3
135799,3,6,0,1,10,0.3,0.3
187520,2,5,0,3,10,0.2,0.3
135776,3,6,0,1,10,0.3,0.3
174726,7,13,0,0,20,0.35,0.3
203044,7,13,0,0,20,0.35,0.3
49109,6,12,0,2,20,0.3,0.3
243312,3,6,0,1,10,0.3,0.3
117111,6,12,0,2,20,0.3,0.3
211770,3,6,0,1,10,0.3,0.3
110317,3,6,0,1,10,0.3,0.3
135681,2,5,0,3,10,0.2,0.3
197364,18,34,0,1,53,0.33962264150943394,0.3018867924528302
231393,11,21,1,0,33,0.3333333333333333,0.30303030303030304
171445,8,15,0,0,23,0.34782608695652173,0.30434782608695654
275970,15,29,0,2,46,0.32608695652173914,0.30434782608695654
153054,8,15,0,0,23,0.34782608695652173,0.30434782608695654
189080,7,14,1,1,23,0.30434782608695654,0.30434782608695654
53278,6,13,0,4,23,0.2608695652173913,0.30434782608695654
276641,6,13,0,4,23,0.2608695652173913,0.30434782608695654
90198,8,15,0,0,23,0.34782608695652173,0.30434782608695654
31343,4,8,0,1,13,0.3076923076923077,0.3076923076923077
261603,13,25,0,1,39,0.3333333333333333,0.3076923076923077
240333,4,8,0,1,13,0.3076923076923077,0.3076923076923077
151503,4,8,0,1,13,0.3076923076923077,0.3076923076923077
121264,8,16,0,2,26,0.3076923076923077,0.3076923076923077
82893,9,17,0,0,26,0.34615384615384615,0.3076923076923077
127481,3,7,0,3,13,0.23076923076923078,0.3076923076923077
225686,4,8,0,1,13,0.3076923076923077,0.3076923076923077
231263,3,7,0,3,13,0.23076923076923078,0.3076923076923077
25533,3,7,0,3,13,0.23076923076923078,0.3076923076923077
170513,17,34,0,4,55,0.3090909090909091,0.3090909090909091
20060,13,26,0,3,42,0.30952380952380953,0.30952380952380953
55892,13,26,1,2,42,0.30952380952380953,0.30952380952380953
226205,10,19,0,0,29,0.3448275862068966,0.3103448275862069
14521,10,19,0,0,29,0.3448275862068966,0.3103448275862069
190923,8,17,0,4,29,0.27586206896551724,0.3103448275862069
249111,5,10,0,1,16,0.3125,0.3125
233526,5,10,0,1,16,0.3125,0.3125
138010,4,9,0,3,16,0.25,0.3125
35445,4,9,0,3,16,0.25,0.3125
223879,5,10,0,1,16,0.3125,0.3125
162030,5,10,0,1,16,0.3125,0.3125
48046,11,22,0,2,35,0.3142857142857143,0.3142857142857143
269835,6,12,0,1,19,0.3157894736842105,0.3157894736842105
33580,6,12,0,1,19,0.3157894736842105,0.3157894736842105
55548,6,12,0,1,19,0.3157894736842105,0.3157894736842105
142623,6,12,0,1,19,0.3157894736842105,0.3157894736842105
167521,4,10,0,5,19,0.21052631578947367,0.3157894736842105
222941,6,12,0,1,19,0.3157894736842105,0.3157894736842105
134837,4,11,0,7,22,0.18181818181818182,0.3181818181818182
80945,13,27,0,4,44,0.29545454545454547,0.3181818181818182
28634,22,46,0,7,75,0.29333333333333333,0.32
207259,10,20,0,1,31,0.3225806451612903,0.3225806451612903
193458,16,32,0,1,49,0.32653061224489793,0.32653061224489793
257024,7,14,0,0,21,0.3333333333333333,0.3333333333333333
206219,7,14,0,0,21,0.3333333333333333,0.3333333333333333
104098,1,3,0,2,6,0.16666666666666666,0.3333333333333333
75330,2,4,0,0,6,0.3333333333333333,0.3333333333333333
270863,2,4,0,0,6,0.3333333333333333,0.3333333333333333
212411,2,4,0,0,6,0.3333333333333333,0.3333333333333333
160746,2,4,0,0,6,0.3333333333333333,0.3333333333333333
258011,3,6,0,0,9,0.3333333333333333,0.3333333333333333
63360,4,8,0,0,12,0.3333333333333333,0.3333333333333333
212427,2,4,0,0,6,0.3333333333333333,0.3333333333333333
157380,4,8,0,0,12,0.3333333333333333,0.3333333333333333
138138,2,4,0,0,6,0.3333333333333333,0.3333333333333333
161250,2,4,0,0,6,0.3333333333333333,0.3333333333333333
63452,2,4,0,0,6,0.3333333333333333,0.3333333333333333
73741,3,6,0,0,9,0.3333333333333333,0.3333333333333333
207341,4,9,0,2,15,0.26666666666666666,0.3333333333333333
37310,3,6,0,0,9,0.3333333333333333,0.3333333333333333
258550,2,4,0,0,6,0.3333333333333333,0.3333333333333333
72530,4,8,0,0,12,0.3333333333333333,0.3333333333333333
236700,2,4,0,0,6,0.3333333333333333,0.3333333333333333
45255,2,4,0,0,6,0.3333333333333333,0.3333333333333333
207782,16,32,0,0,48,0.3333333333333333,0.3333333333333333
38933,4,8,0,0,12,0.3333333333333333,0.3333333333333333
37605,2,4,0,0,6,0.3333333333333333,0.3333333333333333
263078,2,4,0,0,6,0.3333333333333333,0.3333333333333333
199871,3,6,0,0,9,0.3333333333333333,0.3333333333333333
269344,3,6,0,0,9,0.3333333333333333,0.3333333333333333
118955,2,4,0,0,6,0.3333333333333333,0.3333333333333333
200323,2,4,0,0,6,0.3333333333333333,0.3333333333333333
141109,2,5,0,2,9,0.2222222222222222,0.3333333333333333
4795,3,6,0,0,9,0.3333333333333333,0.3333333333333333
111847,8,16,0,0,24,0.3333333333333333,0.3333333333333333
232929,2,4,0,0,6,0.3333333333333333,0.3333333333333333
148632,2,4,0,0,6,0.3333333333333333,0.3333333333333333
112765,2,4,0,0,6,0.3333333333333333,0.3333333333333333
232271,2,4,0,0,6,0.3333333333333333,0.3333333333333333
65068,2,4,0,0,6,0.3333333333333333,0.3333333333333333
232211,3,6,0,0,9,0.3333333333333333,0.3333333333333333
147686,5,12,0,4,21,0.23809523809523808,0.3333333333333333
142565,2,4,0,0,6,0.3333333333333333,0.3333333333333333
8314,2,4,0,0,6,0.3333333333333333,0.3333333333333333
42611,2,4,0,0,6,0.3333333333333333,0.3333333333333333
114306,2,4,0,0,6,0.3333333333333333,0.3333333333333333
67415,2,4,0,0,6,0.3333333333333333,0.3333333333333333
67403,2,4,0,0,6,0.3333333333333333,0.3333333333333333
7312,2,4,0,0,6,0.3333333333333333,0.3333333333333333
42573,4,8,0,0,12,0.3333333333333333,0.3333333333333333
203877,2,4,0,0,6,0.3333333333333333,0.3333333333333333
116582,2,4,0,0,6,0.3333333333333333,0.3333333333333333
115953,2,4,0,0,6,0.3333333333333333,0.3333333333333333
142121,13,27,0,2,42,0.30952380952380953,0.3333333333333333
155743,3,6,0,0,9,0.3333333333333333,0.3333333333333333
53365,2,4,0,0,6,0.3333333333333333,0.3333333333333333
65032,3,6,0,0,9,0.3333333333333333,0.3333333333333333
121093,2,4,0,0,6,0.3333333333333333,0.3333333333333333
236030,2,4,0,0,6,0.3333333333333333,0.3333333333333333
235952,3,6,0,0,9,0.3333333333333333,0.3333333333333333
3331,2,5,0,2,9,0.2222222222222222,0.3333333333333333
260067,4,8,0,0,12,0.3333333333333333,0.3333333333333333
223455,2,4,0,0,6,0.3333333333333333,0.3333333333333333
71193,1,3,0,2,6,0.16666666666666666,0.3333333333333333
154675,2,4,0,0,6,0.3333333333333333,0.3333333333333333
14393,2,4,0,0,6,0.3333333333333333,0.3333333333333333
108197,2,4,0,0,6,0.3333333333333333,0.3333333333333333
108213,2,4,0,0,6,0.3333333333333333,0.3333333333333333
13973,3,6,0,0,9,0.3333333333333333,0.3333333333333333
262391,3,6,0,0,9,0.3333333333333333,0.3333333333333333
139376,2,4,0,0,6,0.3333333333333333,0.3333333333333333
234623,5,12,0,4,21,0.23809523809523808,0.3333333333333333
153513,6,12,0,0,18,0.3333333333333333,0.3333333333333333
3640,3,6,0,0,9,0.3333333333333333,0.3333333333333333
12707,2,4,0,0,6,0.3333333333333333,0.3333333333333333
12698,2,4,0,0,6,0.3333333333333333,0.3333333333333333
12619,2,4,0,0,6,0.3333333333333333,0.3333333333333333
140005,2,4,0,0,6,0.3333333333333333,0.3333333333333333
152483,2,4,0,0,6,0.3333333333333333,0.3333333333333333
262186,2,4,0,0,6,0.3333333333333333,0.3333333333333333
205487,2,4,0,0,6,0.3333333333333333,0.3333333333333333
161373,2,4,0,0,6,0.3333333333333333,0.3333333333333333
109287,2,4,0,0,6,0.3333333333333333,0.3333333333333333
13331,2,4,0,0,6,0.3333333333333333,0.3333333333333333
55438,6,12,0,0,18,0.3333333333333333,0.3333333333333333
116301,4,8,0,0,12,0.3333333333333333,0.3333333333333333
276291,2,4,0,0,6,0.3333333333333333,0.3333333333333333
92524,2,4,0,0,6,0.3333333333333333,0.3333333333333333
225411,2,4,0,0,6,0.3333333333333333,0.3333333333333333
247537,2,4,0,0,6,0.3333333333333333,0.3333333333333333
97721,5,10,0,0,15,0.3333333333333333,0.3333333333333333
274618,2,4,0,0,6,0.3333333333333333,0.3333333333333333
178199,18,37,0,2,57,0.3157894736842105,0.3333333333333333
189392,5,11,0,2,18,0.2777777777777778,0.3333333333333333
178093,2,4,0,0,6,0.3333333333333333,0.3333333333333333
166141,1,4,0,4,9,0.1111111111111111,0.3333333333333333
185087,4,8,0,0,12,0.3333333333333333,0.3333333333333333
247444,3,6,0,0,9,0.3333333333333333,0.3333333333333333
53628,2,5,0,2,9,0.2222222222222222,0.3333333333333333
59612,3,6,0,0,9,0.3333333333333333,0.3333333333333333
126053,2,4,0,0,6,0.3333333333333333,0.3333333333333333
251890,2,4,0,0,6,0.3333333333333333,0.3333333333333333
81064,2,4,0,0,6,0.3333333333333333,0.3333333333333333
51805,2,4,0,0,6,0.3333333333333333,0.3333333333333333
31250,2,4,0,0,6,0.3333333333333333,0.3333333333333333
247010,3,6,0,0,9,0.3333333333333333,0.3333333333333333
90766,1,4,0,4,9,0.1111111111111111,0.3333333333333333
77585,2,4,0,0,6,0.3333333333333333,0.3333333333333333
80837,3,6,0,0,9,0.3333333333333333,0.3333333333333333
92648,2,4,0,0,6,0.3333333333333333,0.3333333333333333
61028,6,12,0,0,18,0.3333333333333333,0.3333333333333333
209163,2,4,0,0,6,0.3333333333333333,0.3333333333333333
181995,2,4,0,0,6,0.3333333333333333,0.3333333333333333
161533,2,4,0,0,6,0.3333333333333333,0.3333333333333333
170012,2,4,0,0,6,0.3333333333333333,0.3333333333333333
244873,2,4,0,0,6,0.3333333333333333,0.3333333333333333
32802,8,16,0,0,24,0.3333333333333333,0.3333333333333333
124720,3,6,0,0,9,0.3333333333333333,0.3333333333333333
24641,2,5,0,2,9,0.2222222222222222,0.3333333333333333
46907,3,6,0,0,9,0.3333333333333333,0.3333333333333333
124474,3,6,0,0,9,0.3333333333333333,0.3333333333333333
22975,2,4,0,0,6,0.3333333333333333,0.3333333333333333
218844,2,4,0,0,6,0.3333333333333333,0.3333333333333333
248464,7,15,0,2,24,0.2916666666666667,0.3333333333333333
168464,2,4,0,0,6,0.3333333333333333,0.3333333333333333
95509,3,6,0,0,9,0.3333333333333333,0.3333333333333333
124298,5,10,0,0,15,0.3333333333333333,0.3333333333333333
80661,2,4,0,0,6,0.3333333333333333,0.3333333333333333
33656,2,4,0,0,6,0.3333333333333333,0.3333333333333333
58351,2,4,0,0,6,0.3333333333333333,0.3333333333333333
56663,2,4,0,0,6,0.3333333333333333,0.3333333333333333
167782,2,4,0,0,6,0.3333333333333333,0.3333333333333333
96019,1,3,0,2,6,0.16666666666666666,0.3333333333333333
222614,2,4,0,0,6,0.3333333333333333,0.3333333333333333
214042,2,4,0,0,6,0.3333333333333333,0.3333333333333333
35631,2,4,0,0,6,0.3333333333333333,0.3333333333333333
216435,3,6,0,0,9,0.3333333333333333,0.3333333333333333
174615,3,6,0,0,9,0.3333333333333333,0.3333333333333333
127131,5,10,0,0,15,0.3333333333333333,0.3333333333333333
18203,2,4,0,0,6,0.3333333333333333,0.3333333333333333
85043,3,7,0,2,12,0.25,0.3333333333333333
50205,3,6,0,0,9,0.3333333333333333,0.3333333333333333
162762,2,4,0,0,6,0.3333333333333333,0.3333333333333333
59038,4,8,0,0,12,0.3333333333333333,0.3333333333333333
273344,4,9,0,2,15,0.26666666666666666,0.3333333333333333
1585,3,6,0,0,9,0.3333333333333333,0.3333333333333333
128915,3,6,0,0,9,0.3333333333333333,0.3333333333333333
102032,2,4,0,0,6,0.3333333333333333,0.3333333333333333
242914,2,4,0,0,6,0.3333333333333333,0.3333333333333333
57124,1,3,0,2,6,0.16666666666666666,0.3333333333333333
254971,2,4,0,0,6,0.3333333333333333,0.3333333333333333
243075,3,6,0,0,9,0.3333333333333333,0.3333333333333333
272715,1,4,0,4,9,0.1111111111111111,0.3333333333333333
47779,1,3,0,2,6,0.16666666666666666,0.3333333333333333
161880,2,4,0,0,6,0.3333333333333333,0.3333333333333333
102359,7,18,0,8,33,0.21212121212121213,0.3333333333333333
180840,3,6,0,0,9,0.3333333333333333,0.3333333333333333
255858,2,4,0,0,6,0.3333333333333333,0.3333333333333333
219671,2,4,0,0,6,0.3333333333333333,0.3333333333333333
59209,4,9,0,2,15,0.26666666666666666,0.3333333333333333
254376,2,4,0,0,6,0.3333333333333333,0.3333333333333333
181176,13,26,0,0,39,0.3333333333333333,0.3333333333333333
182599,2,4,0,0,6,0.3333333333333333,0.3333333333333333
90137,3,6,0,0,9,0.3333333333333333,0.3333333333333333
244189,3,6,0,0,9,0.3333333333333333,0.3333333333333333
215709,2,4,0,0,6,0.3333333333333333,0.3333333333333333
30333,3,6,0,0,9,0.3333333333333333,0.3333333333333333
131655,2,4,0,0,6,0.3333333333333333,0.3333333333333333
246247,4,11,0,6,21,0.19047619047619047,0.3333333333333333
20147,1,3,0,2,6,0.16666666666666666,0.3333333333333333
245963,3,6,0,0,9,0.3333333333333333,0.3333333333333333
123867,6,12,0,0,18,0.3333333333333333,0.3333333333333333
190885,5,10,0,0,15,0.3333333333333333,0.3333333333333333
273507,1,3,0,2,6,0.16666666666666666,0.3333333333333333
33200,3,6,0,0,9,0.3333333333333333,0.3333333333333333
176094,2,4,0,0,6,0.3333333333333333,0.3333333333333333
215627,2,4,0,0,6,0.3333333333333333,0.3333333333333333
128732,5,10,0,0,15,0.3333333333333333,0.3333333333333333
130168,2,4,0,0,6,0.3333333333333333,0.3333333333333333
208095,3,6,0,0,9,0.3333333333333333,0.3333333333333333
135996,3,6,0,0,9,0.3333333333333333,0.3333333333333333
253602,2,5,0,2,9,0.2222222222222222,0.3333333333333333
212328,6,12,0,0,18,0.3333333333333333,0.3333333333333333
163415,2,4,0,0,6,0.3333333333333333,0.3333333333333333
93629,19,39,0,0,58,0.3275862068965517,0.3448275862068966
250925,8,18,0,3,29,0.27586206896551724,0.3448275862068966
193529,8,17,0,1,26,0.3076923076923077,0.34615384615384615
217986,8,17,0,1,26,0.3076923076923077,0.34615384615384615
211919,6,15,1,4,26,0.23076923076923078,0.34615384615384615
76942,7,15,0,1,23,0.30434782608695654,0.34782608695652173
222035,7,15,0,1,23,0.30434782608695654,0.34782608695652173
237534,7,15,0,1,23,0.30434782608695654,0.34782608695652173
207494,10,23,0,4,37,0.2702702702702703,0.35135135135135137
165884,5,11,0,1,17,0.29411764705882354,0.35294117647058826
226616,5,11,0,1,17,0.29411764705882354,0.35294117647058826
112083,5,11,0,1,17,0.29411764705882354,0.35294117647058826
55178,4,10,0,3,17,0.23529411764705882,0.35294117647058826
144255,9,20,0,2,31,0.2903225806451613,0.3548387096774194
270820,14,30,0,1,45,0.3111111111111111,0.35555555555555557
81207,4,9,0,1,14,0.2857142857142857,0.35714285714285715
120565,4,9,0,1,14,0.2857142857142857,0.35714285714285715
20971,4,9,0,1,14,0.2857142857142857,0.35714285714285715
15049,8,18,0,2,28,0.2857142857142857,0.35714285714285715
20561,4,9,0,1,14,0.2857142857142857,0.35714285714285715
42410,4,9,0,1,14,0.2857142857142857,0.35714285714285715
269799,4,9,0,1,14,0.2857142857142857,0.35714285714285715
89551,3,8,0,3,14,0.21428571428571427,0.35714285714285715
76352,9,19,0,0,28,0.32142857142857145,0.35714285714285715
277427,17,41,0,9,67,0.2537313432835821,0.3582089552238806
102647,27,58,0,1,86,0.313953488372093,0.36046511627906974
15408,10,23,0,3,36,0.2777777777777778,0.3611111111111111
14768,3,7,0,1,11,0.2727272727272727,0.36363636363636365
198012,5,13,0,4,22,0.22727272727272727,0.36363636363636365
240401,3,7,0,1,11,0.2727272727272727,0.36363636363636365
214272,2,6,0,3,11,0.18181818181818182,0.36363636363636365
245650,10,22,0,1,33,0.30303030303030304,0.36363636363636365
259320,7,15,0,0,22,0.3181818181818182,0.36363636363636365
148258,8,20,0,5,33,0.24242424242424243,0.36363636363636365
199209,3,7,0,1,11,0.2727272727272727,0.36363636363636365
30898,3,7,0,1,11,0.2727272727272727,0.36363636363636365
199092,3,7,0,1,11,0.2727272727272727,0.36363636363636365
213760,3,7,0,1,11,0.2727272727272727,0.36363636363636365
234954,3,7,0,1,11,0.2727272727272727,0.36363636363636365
25253,3,7,0,1,11,0.2727272727272727,0.36363636363636365
96357,13,28,0,0,41,0.3170731707317073,0.36585365853658536
149069,9,20,0,1,30,0.3,0.36666666666666664
236948,5,12,0,2,19,0.2631578947368421,0.3684210526315789
224525,4,11,0,4,19,0.21052631578947367,0.3684210526315789
182334,5,12,0,2,19,0.2631578947368421,0.3684210526315789
265487,6,13,0,0,19,0.3157894736842105,0.3684210526315789
238889,11,24,0,0,35,0.3142857142857143,0.37142857142857144
638,10,23,0,2,35,0.2857142857142857,0.37142857142857144
263560,2,5,0,1,8,0.25,0.375
61348,2,5,0,1,8,0.25,0.375
23699,5,11,0,0,16,0.3125,0.375
39396,2,5,0,1,8,0.25,0.375
218875,2,5,0,1,8,0.25,0.375
104665,15,33,0,0,48,0.3125,0.375
29028,2,5,0,1,8,0.25,0.375
92810,19,43,0,2,64,0.296875,0.375
110040,2,5,0,1,8,0.25,0.375
182459,7,16,0,1,24,0.2916666666666667,0.375
96493,1,4,0,3,8,0.125,0.375
270339,2,5,0,1,8,0.25,0.375
40640,0,3,0,5,8,0.0,0.375
805,5,11,0,0,16,0.3125,0.375
120828,4,10,0,2,16,0.25,0.375
235842,2,5,0,1,8,0.25,0.375
256925,2,5,0,1,8,0.25,0.375
251423,2,5,0,1,8,0.25,0.375
244995,1,4,0,3,8,0.125,0.375
46541,2,5,0,1,8,0.25,0.375
153042,2,5,0,1,8,0.25,0.375
98741,3,9,0,4,16,0.1875,0.375
111578,5,13,0,3,21,0.23809523809523808,0.38095238095238093
163358,5,13,0,3,21,0.23809523809523808,0.38095238095238093
7283,6,14,0,1,21,0.2857142857142857,0.38095238095238093
68760,6,14,0,1,21,0.2857142857142857,0.38095238095238093
108352,6,14,0,1,21,0.2857142857142857,0.38095238095238093
135045,15,35,0,2,52,0.28846153846153844,0.38461538461538464
49314,4,9,0,0,13,0.3076923076923077,0.38461538461538464
54898,4,9,0,0,13,0.3076923076923077,0.38461538461538464
182442,4,9,0,0,13,0.3076923076923077,0.38461538461538464
16504,4,9,0,0,13,0.3076923076923077,0.38461538461538464
47609,4,9,0,0,13,0.3076923076923077,0.38461538461538464
252848,4,9,0,0,13,0.3076923076923077,0.38461538461538464
273718,4,9,0,0,13,0.3076923076923077,0.38461538461538464
89207,0,5,0,8,13,0.0,0.38461538461538464
178914,4,9,0,0,13,0.3076923076923077,0.38461538461538464
9227,4,9,0,0,13,0.3076923076923077,0.38461538461538464
91002,4,9,0,0,13,0.3076923076923077,0.38461538461538464
140879,3,8,0,2,13,0.23076923076923078,0.38461538461538464
165582,4,9,0,0,13,0.3076923076923077,0.38461538461538464
24933,8,20,0,3,31,0.25806451612903225,0.3870967741935484
77181,4,11,0,3,18,0.2222222222222222,0.3888888888888889
18082,6,15,0,2,23,0.2608695652173913,0.391304347826087
215986,8,19,0,1,28,0.2857142857142857,0.39285714285714285
12824,8,19,0,1,28,0.2857142857142857,0.39285714285714285
203742,1,3,0,1,5,0.2,0.4
276964,3,7,0,0,10,0.3,0.4
140080,1,3,0,1,5,0.2,0.4
267895,1,3,0,1,5,0.2,0.4
272395,1,3,0,1,5,0.2,0.4
271538,3,7,0,0,10,0.3,0.4
137620,3,7,0,0,10,0.3,0.4
207965,3,7,0,0,10,0.3,0.4
122901,1,3,0,1,5,0.2,0.4
271156,1,3,0,1,5,0.2,0.4
122506,4,10,0,1,15,0.26666666666666666,0.4
54222,1,3,0,1,5,0.2,0.4
63507,3,7,0,0,10,0.3,0.4
138382,1,3,0,1,5,0.2,0.4
270715,1,3,0,1,5,0.2,0.4
139070,3,7,0,0,10,0.3,0.4
128040,1,3,0,1,5,0.2,0.4
226394,1,3,0,1,5,0.2,0.4
60168,3,7,0,0,10,0.3,0.4
140087,1,3,0,1,5,0.2,0.4
133846,1,3,0,1,5,0.2,0.4
99,0,2,0,3,5,0.0,0.4
54578,1,3,0,1,5,0.2,0.4
47458,1,3,0,1,5,0.2,0.4
118422,1,3,0,1,5,0.2,0.4
118414,1,3,0,1,5,0.2,0.4
142398,1,3,0,1,5,0.2,0.4
131594,4,10,0,1,15,0.26666666666666666,0.4
6073,7,17,0,1,25,0.28,0.4
130705,8,20,0,2,30,0.26666666666666666,0.4
60905,1,3,0,1,5,0.2,0.4
84866,1,3,0,1,5,0.2,0.4
65665,1,3,0,1,5,0.2,0.4
33319,4,10,0,1,15,0.26666666666666666,0.4
25103,1,3,1,0,5,0.2,0.4
37293,4,10,0,1,15,0.26666666666666666,0.4
104413,2,6,0,2,10,0.2,0.4
176853,1,3,0,1,5,0.2,0.4
89192,1,5,0,4,10,0.1,0.4
175271,3,7,0,0,10,0.3,0.4
150966,1,3,0,1,5,0.2,0.4
242465,1,3,0,1,5,0.2,0.4
200206,3,7,0,0,10,0.3,0.4
222488,1,5,0,4,10,0.1,0.4
52994,1,3,0,1,5,0.2,0.4
16666,1,3,0,1,5,0.2,0.4
55065,1,3,0,1,5,0.2,0.4
38899,1,3,0,1,5,0.2,0.4
91428,1,3,0,1,5,0.2,0.4
234165,6,14,0,0,20,0.3,0.4
37538,10,26,0,4,40,0.25,0.4
249096,1,3,0,1,5,0.2,0.4
91931,1,5,0,4,10,0.1,0.4
195247,0,2,0,3,5,0.0,0.4
72183,1,3,0,1,5,0.2,0.4
240670,1,3,0,1,5,0.2,0.4
214244,0,2,0,3,5,0.0,0.4
170810,1,3,0,1,5,0.2,0.4
196187,1,3,0,1,5,0.2,0.4
155771,1,3,0,1,5,0.2,0.4
152514,1,3,0,1,5,0.2,0.4
167556,1,3,0,1,5,0.2,0.4
171475,1,3,0,1,5,0.2,0.4
76576,4,10,0,1,15,0.26666666666666666,0.4
84126,1,3,0,1,5,0.2,0.4
83842,1,3,0,1,5,0.2,0.4
238739,1,3,0,1,5,0.2,0.4
20119,3,7,0,0,10,0.3,0.4
54817,0,2,0,3,5,0.0,0.4
67176,1,3,0,1,5,0.2,0.4
7864,1,3,0,1,5,0.2,0.4
264655,1,3,0,1,5,0.2,0.4
166291,1,3,0,1,5,0.2,0.4
101550,1,3,0,1,5,0.2,0.4
243814,1,3,0,1,5,0.2,0.4
231613,1,3,0,1,5,0.2,0.4
83069,1,3,0,1,5,0.2,0.4
201969,12,30,0,3,45,0.26666666666666666,0.4
113752,3,7,0,0,10,0.3,0.4
98422,1,3,0,1,5,0.2,0.4
238541,2,6,0,2,10,0.2,0.4
113475,1,3,0,1,5,0.2,0.4
147752,3,7,0,0,10,0.3,0.4
102571,1,3,0,1,5,0.2,0.4
160558,13,32,0,2,47,0.2765957446808511,0.40425531914893614
14456,11,26,0,0,37,0.2972972972972973,0.40540540540540543
104211,11,26,0,0,37,0.2972972972972973,0.40540540540540543
199515,8,19,0,0,27,0.2962962962962963,0.4074074074074074
266866,0,11,0,16,27,0.0,0.4074074074074074
27617,7,18,0,2,27,0.25925925925925924,0.4074074074074074
208671,19,48,0,4,71,0.2676056338028169,0.4084507042253521
243328,6,15,0,1,22,0.2727272727272727,0.4090909090909091
234765,6,15,0,1,22,0.2727272727272727,0.4090909090909091
41841,9,23,0,2,34,0.2647058823529412,0.4117647058823529
267635,8,20,0,1,29,0.27586206896551724,0.41379310344827586
105221,8,20,0,1,29,0.27586206896551724,0.41379310344827586
19711,8,20,0,1,29,0.27586206896551724,0.41379310344827586
273307,3,8,0,1,12,0.25,0.4166666666666667
161882,3,8,0,1,12,0.25,0.4166666666666667
62303,0,5,0,7,12,0.0,0.4166666666666667
169779,7,17,0,0,24,0.2916666666666667,0.4166666666666667
238222,3,8,0,1,12,0.25,0.4166666666666667
155495,3,8,0,1,12,0.25,0.4166666666666667
203900,3,8,0,1,12,0.25,0.4166666666666667
224340,3,8,0,1,12,0.25,0.4166666666666667
42914,7,17,0,0,24,0.2916666666666667,0.4166666666666667
40922,3,8,0,1,12,0.25,0.4166666666666667
231354,6,16,0,2,24,0.25,0.4166666666666667
173291,9,22,0,0,31,0.2903225806451613,0.41935483870967744
154992,5,13,0,1,19,0.2631578947368421,0.42105263157894735
86243,9,23,0,1,33,0.2727272727272727,0.42424242424242425
78901,2,5,0,0,7,0.2857142857142857,0.42857142857142855
22089,2,5,0,0,7,0.2857142857142857,0.42857142857142855
58342,2,5,0,0,7,0.2857142857142857,0.42857142857142855
46269,3,9,0,2,14,0.21428571428571427,0.42857142857142855
239788,0,3,0,4,7,0.0,0.42857142857142855
82955,2,5,0,0,7,0.2857142857142857,0.42857142857142855
25225,2,5,0,0,7,0.2857142857142857,0.42857142857142855
226393,2,5,0,0,7,0.2857142857142857,0.42857142857142855
34636,2,5,0,0,7,0.2857142857142857,0.42857142857142855
244761,2,5,0,0,7,0.2857142857142857,0.42857142857142855
30261,1,4,0,2,7,0.14285714285714285,0.42857142857142855
58458,1,4,0,2,7,0.14285714285714285,0.42857142857142855
76888,6,15,0,0,21,0.2857142857142857,0.42857142857142855
130166,2,5,0,0,7,0.2857142857142857,0.42857142857142855
215256,2,5,0,0,7,0.2857142857142857,0.42857142857142855
87540,2,5,0,0,7,0.2857142857142857,0.42857142857142855
250405,2,5,0,0,7,0.2857142857142857,0.42857142857142855
92658,2,5,0,0,7,0.2857142857142857,0.42857142857142855
134347,2,5,0,0,7,0.2857142857142857,0.42857142857142855
47117,2,5,0,0,7,0.2857142857142857,0.42857142857142855
172331,2,5,0,0,7,0.2857142857142857,0.42857142857142855
170522,2,5,0,0,7,0.2857142857142857,0.42857142857142855
241666,20,50,0,0,70,0.2857142857142857,0.42857142857142855
214686,2,5,0,0,7,0.2857142857142857,0.42857142857142855
94242,2,5,0,0,7,0.2857142857142857,0.42857142857142855
126149,4,10,0,0,14,0.2857142857142857,0.42857142857142855
240495,2,5,0,0,7,0.2857142857142857,0.42857142857142855
91017,4,10,0,0,14,0.2857142857142857,0.42857142857142855
94376,2,5,0,0,7,0.2857142857142857,0.42857142857142855
275673,2,5,0,0,7,0.2857142857142857,0.42857142857142855
210077,2,5,0,0,7,0.2857142857142857,0.42857142857142855
28289,2,5,0,0,7,0.2857142857142857,0.42857142857142855
94495,2,5,0,0,7,0.2857142857142857,0.42857142857142855
183277,2,5,0,0,7,0.2857142857142857,0.42857142857142855
215421,2,5,0,0,7,0.2857142857142857,0.42857142857142855
245194,1,4,0,2,7,0.14285714285714285,0.42857142857142855
22495,1,4,0,2,7,0.14285714285714285,0.42857142857142855
244,2,5,0,0,7,0.2857142857142857,0.42857142857142855
254467,2,5,0,0,7,0.2857142857142857,0.42857142857142855
101196,2,5,0,0,7,0.2857142857142857,0.42857142857142855
258109,2,5,0,0,7,0.2857142857142857,0.42857142857142855
72707,1,4,0,2,7,0.14285714285714285,0.42857142857142855
236621,2,5,0,0,7,0.2857142857142857,0.42857142857142855
213066,2,5,0,0,7,0.2857142857142857,0.42857142857142855
119248,2,5,0,0,7,0.2857142857142857,0.42857142857142855
110208,2,5,0,0,7,0.2857142857142857,0.42857142857142855
122321,1,4,0,2,7,0.14285714285714285,0.42857142857142855
155989,2,5,0,0,7,0.2857142857142857,0.42857142857142855
259734,2,5,0,0,7,0.2857142857142857,0.42857142857142855
196018,1,4,0,2,7,0.14285714285714285,0.42857142857142855
152016,2,5,0,0,7,0.2857142857142857,0.42857142857142855
109388,2,5,0,0,7,0.2857142857142857,0.42857142857142855
155376,2,5,0,0,7,0.2857142857142857,0.42857142857142855
71587,3,9,0,2,14,0.21428571428571427,0.42857142857142855
198781,2,5,0,0,7,0.2857142857142857,0.42857142857142855
100471,2,5,0,0,7,0.2857142857142857,0.42857142857142855
120137,2,5,0,0,7,0.2857142857142857,0.42857142857142855
159720,2,5,0,0,7,0.2857142857142857,0.42857142857142855
197727,2,5,0,0,7,0.2857142857142857,0.42857142857142855
159863,1,4,0,2,7,0.14285714285714285,0.42857142857142855
193819,2,5,0,0,7,0.2857142857142857,0.42857142857142855
203422,2,5,0,0,7,0.2857142857142857,0.42857142857142855
115679,2,5,0,0,7,0.2857142857142857,0.42857142857142855
116931,2,5,0,0,7,0.2857142857142857,0.42857142857142855
18439,2,5,0,0,7,0.2857142857142857,0.42857142857142855
117256,2,5,0,0,7,0.2857142857142857,0.42857142857142855
114265,0,3,0,4,7,0.0,0.42857142857142855
223872,2,5,0,0,7,0.2857142857142857,0.42857142857142855
257699,2,5,0,0,7,0.2857142857142857,0.42857142857142855
2010,2,5,0,0,7,0.2857142857142857,0.42857142857142855
217516,4,10,0,0,14,0.2857142857142857,0.42857142857142855
193469,4,10,0,0,14,0.2857142857142857,0.42857142857142855
43093,2,5,0,0,7,0.2857142857142857,0.42857142857142855
148962,2,5,0,0,7,0.2857142857142857,0.42857142857142855
141310,2,5,0,0,7,0.2857142857142857,0.42857142857142855
160994,2,5,0,0,7,0.2857142857142857,0.42857142857142855
74833,2,5,0,0,7,0.2857142857142857,0.42857142857142855
234743,2,5,0,0,7,0.2857142857142857,0.42857142857142855
162738,15,41,1,3,60,0.25,0.43333333333333335
105374,6,16,0,1,23,0.2608695652173913,0.43478260869565216
53220,20,55,0,5,80,0.25,0.4375
143909,4,11,0,1,16,0.25,0.4375
271558,9,23,0,0,32,0.28125,0.4375
134311,4,11,0,1,16,0.25,0.4375
260183,7,21,0,4,32,0.21875,0.4375
234597,10,28,0,3,41,0.24390243902439024,0.43902439024390244
245371,6,17,0,2,25,0.24,0.44
91631,0,4,0,5,9,0.0,0.4444444444444444
219951,2,6,0,1,9,0.2222222222222222,0.4444444444444444
116866,2,6,0,1,9,0.2222222222222222,0.4444444444444444
230115,2,6,0,1,9,0.2222222222222222,0.4444444444444444
115552,2,6,0,1,9,0.2222222222222222,0.4444444444444444
182053,5,13,0,0,18,0.2777777777777778,0.4444444444444444
136255,5,13,0,0,18,0.2777777777777778,0.4444444444444444
178151,2,6,0,1,9,0.2222222222222222,0.4444444444444444
192245,5,13,0,0,18,0.2777777777777778,0.4444444444444444
102945,2,6,0,1,9,0.2222222222222222,0.4444444444444444
8782,2,6,0,1,9,0.2222222222222222,0.4444444444444444
172700,2,6,0,1,9,0.2222222222222222,0.4444444444444444
111241,2,6,0,1,9,0.2222222222222222,0.4444444444444444
176481,2,6,0,1,9,0.2222222222222222,0.4444444444444444
243077,5,13,0,0,18,0.2777777777777778,0.4444444444444444
196053,5,13,0,0,18,0.2777777777777778,0.4444444444444444
39159,1,5,0,3,9,0.1111111111111111,0.4444444444444444
56391,5,13,0,0,18,0.2777777777777778,0.4444444444444444
152579,5,13,0,0,18,0.2777777777777778,0.4444444444444444
208815,5,13,0,0,18,0.2777777777777778,0.4444444444444444
49460,10,27,0,1,38,0.2631578947368421,0.4473684210526316
53614,8,21,0,0,29,0.27586206896551724,0.4482758620689655
110373,8,21,0,0,29,0.27586206896551724,0.4482758620689655
84882,8,21,0,0,29,0.27586206896551724,0.4482758620689655
247129,8,26,0,6,40,0.2,0.45
48025,19,52,0,2,73,0.2602739726027397,0.4520547945205479
48268,3,8,0,0,11,0.2727272727272727,0.45454545454545453
123988,3,8,0,0,11,0.2727272727272727,0.45454545454545453
115692,9,24,0,0,33,0.2727272727272727,0.45454545454545453
242037,2,7,0,2,11,0.18181818181818182,0.45454545454545453
164096,4,14,0,4,22,0.18181818181818182,0.45454545454545453
64946,3,8,0,0,11,0.2727272727272727,0.45454545454545453
216962,3,8,0,0,11,0.2727272727272727,0.45454545454545453
112845,3,8,0,0,11,0.2727272727272727,0.45454545454545453
82825,3,8,0,0,11,0.2727272727272727,0.45454545454545453
2030,3,8,0,0,11,0.2727272727272727,0.45454545454545453
95903,6,16,0,0,22,0.2727272727272727,0.45454545454545453
87929,3,8,0,0,11,0.2727272727272727,0.45454545454545453
112298,3,8,0,0,11,0.2727272727272727,0.45454545454545453
2179,3,8,0,0,11,0.2727272727272727,0.45454545454545453
271000,3,8,0,0,11,0.2727272727272727,0.45454545454545453
150498,3,8,0,0,11,0.2727272727272727,0.45454545454545453
175101,3,8,0,0,11,0.2727272727272727,0.45454545454545453
270156,3,8,0,0,11,0.2727272727272727,0.45454545454545453
136010,14,40,1,2,57,0.24561403508771928,0.45614035087719296
174596,8,24,0,3,35,0.22857142857142856,0.45714285714285713
219546,6,17,0,1,24,0.25,0.4583333333333333
185722,6,17,0,1,24,0.25,0.4583333333333333
246311,19,54,0,3,76,0.25,0.4605263157894737
253226,3,9,0,1,13,0.23076923076923078,0.46153846153846156
134483,3,9,0,1,13,0.23076923076923078,0.46153846153846156
161467,3,9,0,1,13,0.23076923076923078,0.46153846153846156
28667,3,9,0,1,13,0.23076923076923078,0.46153846153846156
152696,3,9,0,1,13,0.23076923076923078,0.46153846153846156
33818,10,30,0,3,43,0.23255813953488372,0.46511627906976744
240035,12,33,0,0,45,0.26666666666666666,0.4666666666666667
230013,4,11,0,0,15,0.26666666666666666,0.4666666666666667
266226,7,21,0,2,30,0.23333333333333334,0.4666666666666667
224768,4,11,0,0,15,0.26666666666666666,0.4666666666666667
5499,4,11,0,0,15,0.26666666666666666,0.4666666666666667
270737,4,11,0,0,15,0.26666666666666666,0.4666666666666667
120093,8,22,0,0,30,0.26666666666666666,0.4666666666666667
197502,4,11,0,0,15,0.26666666666666666,0.4666666666666667
204359,4,11,0,0,15,0.26666666666666666,0.4666666666666667
192244,4,11,0,0,15,0.26666666666666666,0.4666666666666667
57599,4,11,0,0,15,0.26666666666666666,0.4666666666666667
244915,4,11,0,0,15,0.26666666666666666,0.4666666666666667
163851,4,11,0,0,15,0.26666666666666666,0.4666666666666667
126388,8,23,0,1,32,0.25,0.46875
197687,4,12,0,1,17,0.23529411764705882,0.47058823529411764
71853,4,12,0,1,17,0.23529411764705882,0.47058823529411764
111947,5,14,0,0,19,0.2631578947368421,0.47368421052631576
16916,5,14,0,0,19,0.2631578947368421,0.47368421052631576
250398,5,14,0,0,19,0.2631578947368421,0.47368421052631576
196160,15,44,1,1,61,0.2459016393442623,0.47540983606557374
62891,10,30,0,2,42,0.23809523809523808,0.47619047619047616
187624,5,15,0,1,21,0.23809523809523808,0.47619047619047616
240643,5,15,0,1,21,0.23809523809523808,0.47619047619047616
80683,6,17,0,0,23,0.2608695652173913,0.4782608695652174
144478,5,16,0,2,23,0.21739130434782608,0.4782608695652174
21031,5,16,0,2,23,0.21739130434782608,0.4782608695652174
122440,5,16,0,2,23,0.21739130434782608,0.4782608695652174
48355,6,17,0,0,23,0.2608695652173913,0.4782608695652174
130658,6,17,0,0,23,0.2608695652173913,0.4782608695652174
192428,6,18,0,1,25,0.24,0.48
125519,14,43,0,3,60,0.23333333333333334,0.48333333333333334
17950,15,47,0,4,66,0.22727272727272727,0.48484848484848486
108753,2,6,0,0,8,0.25,0.5
153211,3,9,0,0,12,0.25,0.5
260967,1,4,0,1,6,0.16666666666666666,0.5
125892,2,6,0,0,8,0.25,0.5
277744,1,5,0,2,8,0.125,0.5
107889,2,6,0,0,8,0.25,0.5
260419,3,10,0,1,14,0.21428571428571427,0.5
155680,1,4,0,1,6,0.16666666666666666,0.5
16161,2,8,0,2,12,0.16666666666666666,0.5
104268,3,9,0,0,12,0.25,0.5
53663,2,6,0,0,8,0.25,0.5
275758,1,4,0,1,6,0.16666666666666666,0.5
131363,0,5,0,5,10,0.0,0.5
17906,2,6,0,0,8,0.25,0.5
101336,1,4,0,1,6,0.16666666666666666,0.5
163534,0,5,0,5,10,0.0,0.5
20034,2,6,0,0,8,0.25,0.5
277203,0,3,0,3,6,0.0,0.5
276463,5,15,0,0,20,0.25,0.5
128434,3,9,0,0,12,0.25,0.5
252785,2,6,0,0,8,0.25,0.5
159858,7,22,0,1,30,0.23333333333333334,0.5
152428,1,4,0,1,6,0.16666666666666666,0.5
140410,1,4,0,1,6,0.16666666666666666,0.5
119505,3,10,0,1,14,0.21428571428571427,0.5
220314,1,4,0,1,6,0.16666666666666666,0.5
4157,2,6,0,0,8,0.25,0.5
120082,1,4,0,1,6,0.16666666666666666,0.5
5385,2,6,0,0,8,0.25,0.5
122096,2,6,0,0,8,0.25,0.5
142134,2,6,0,0,8,0.25,0.5
144727,1,4,0,1,6,0.16666666666666666,0.5
266522,1,4,0,1,6,0.16666666666666666,0.5
221732,10,31,0,1,42,0.23809523809523808,0.5
271306,4,13,1,0,18,0.2222222222222222,0.5
146083,2,6,0,0,8,0.25,0.5
136747,2,6,0,0,8,0.25,0.5
1075,2,6,0,0,8,0.25,0.5
273440,2,6,0,0,8,0.25,0.5
265656,3,9,0,0,12,0.25,0.5
113817,1,4,0,1,6,0.16666666666666666,0.5
112590,2,6,0,0,8,0.25,0.5
273465,0,3,0,3,6,0.0,0.5
112408,2,7,0,1,10,0.2,0.5
112402,2,6,0,0,8,0.25,0.5
134403,2,8,0,2,12,0.16666666666666666,0.5
275075,1,4,0,1,6,0.16666666666666666,0.5
11687,2,8,0,2,12,0.16666666666666666,0.5
262317,2,6,0,0,8,0.25,0.5
262940,3,9,0,0,12,0.25,0.5
172539,2,6,0,0,8,0.25,0.5
251242,4,12,0,0,16,0.25,0.5
193131,2,6,0,0,8,0.25,0.5
74630,1,6,0,3,10,0.1,0.5
73588,6,18,0,0,24,0.25,0.5
37567,1,5,0,2,8,0.125,0.5
50193,1,4,0,1,6,0.16666666666666666,0.5
235684,2,6,0,0,8,0.25,0.5
234565,1,5,0,2,8,0.125,0.5
233445,4,13,0,1,18,0.2222222222222222,0.5
200245,4,13,0,1,18,0.2222222222222222,0.5
39345,6,18,0,0,24,0.25,0.5
40838,2,6,0,0,8,0.25,0.5
202000,1,4,0,1,6,0.16666666666666666,0.5
67910,2,6,0,0,8,0.25,0.5
230985,0,3,0,3,6,0.0,0.5
51803,4,13,0,1,18,0.2222222222222222,0.5
202942,2,6,0,0,8,0.25,0.5
204474,2,6,0,0,8,0.25,0.5
44296,1,5,0,2,8,0.125,0.5
227192,2,6,0,0,8,0.25,0.5
62464,4,12,0,0,16,0.25,0.5
208019,2,8,0,2,12,0.16666666666666666,0.5
46417,2,6,0,0,8,0.25,0.5
208907,2,6,0,0,8,0.25,0.5
225379,10,32,0,2,44,0.22727272727272727,0.5
224308,2,6,0,0,8,0.25,0.5
209486,3,9,0,0,12,0.25,0.5
47152,2,6,0,0,8,0.25,0.5
225078,4,13,0,1,18,0.2222222222222222,0.5
209817,4,14,0,2,20,0.2,0.5
210035,2,6,0,0,8,0.25,0.5
229502,4,12,0,0,16,0.25,0.5
192121,2,6,0,0,8,0.25,0.5
36741,1,6,0,3,10,0.1,0.5
238836,1,4,0,1,6,0.16666666666666666,0.5
250543,2,6,0,0,8,0.25,0.5
23020,2,6,0,0,8,0.25,0.5
249058,3,9,0,0,12,0.25,0.5
171078,1,4,0,1,6,0.16666666666666666,0.5
248280,2,7,0,1,10,0.2,0.5
211137,1,4,0,1,6,0.16666666666666666,0.5
247423,1,4,0,1,6,0.16666666666666666,0.5
27821,1,4,0,1,6,0.16666666666666666,0.5
175278,2,6,0,0,8,0.25,0.5
28222,2,6,0,0,8,0.25,0.5
51364,1,5,0,2,8,0.125,0.5
87974,1,4,0,1,6,0.16666666666666666,0.5
28543,1,4,0,1,6,0.16666666666666666,0.5
177569,3,9,0,0,12,0.25,0.5
245088,4,12,0,0,16,0.25,0.5
182393,2,6,0,0,8,0.25,0.5
33816,3,9,0,0,12,0.25,0.5
33461,2,6,0,0,8,0.25,0.5
188022,7,21,0,0,28,0.25,0.5
80203,3,9,0,0,12,0.25,0.5
186762,3,9,0,0,12,0.25,0.5
243448,2,6,0,0,8,0.25,0.5
31652,1,4,0,1,6,0.16666666666666666,0.5
31681,0,4,0,4,8,0.0,0.5
31008,2,6,0,0,8,0.25,0.5
81484,2,7,0,1,10,0.2,0.5
242528,3,9,0,0,12,0.25,0.5
173650,1,4,0,1,6,0.16666666666666666,0.5
69355,8,26,0,1,35,0.22857142857142856,0.5142857142857142
209875,6,19,0,0,25,0.24,0.52
81298,5,17,0,1,23,0.21739130434782608,0.5217391304347826
32627,4,14,0,1,19,0.21052631578947367,0.5263157894736842
19085,9,29,0,0,38,0.23684210526315788,0.5263157894736842
8019,4,14,0,1,19,0.21052631578947367,0.5263157894736842
226006,4,14,0,1,19,0.21052631578947367,0.5263157894736842
137336,4,14,0,1,19,0.21052631578947367,0.5263157894736842
190831,3,13,0,3,19,0.15789473684210525,0.5263157894736842
114444,9,29,0,0,38,0.23684210526315788,0.5263157894736842
88122,4,13,0,0,17,0.23529411764705882,0.5294117647058824
131126,4,13,0,0,17,0.23529411764705882,0.5294117647058824
245649,4,13,0,0,17,0.23529411764705882,0.5294117647058824
37874,4,13,0,0,17,0.23529411764705882,0.5294117647058824
93363,7,24,0,1,32,0.21875,0.53125
77383,7,23,0,0,30,0.23333333333333334,0.5333333333333333
179019,10,33,0,0,43,0.23255813953488372,0.5348837209302325
227705,17,61,0,4,82,0.2073170731707317,0.5365853658536586
98484,3,10,0,0,13,0.23076923076923078,0.5384615384615384
100009,3,10,0,0,13,0.23076923076923078,0.5384615384615384
209373,8,29,1,1,39,0.20512820512820512,0.5384615384615384
48579,3,10,0,0,13,0.23076923076923078,0.5384615384615384
59656,2,9,0,2,13,0.15384615384615385,0.5384615384615384
17190,2,9,0,2,13,0.15384615384615385,0.5384615384615384
44252,5,19,0,2,26,0.19230769230769232,0.5384615384615384
233578,3,10,0,0,13,0.23076923076923078,0.5384615384615384
105028,13,48,0,4,65,0.2,0.5384615384615384
58961,3,10,0,0,13,0.23076923076923078,0.5384615384615384
252222,2,9,0,2,13,0.15384615384615385,0.5384615384615384
8872,3,10,0,0,13,0.23076923076923078,0.5384615384615384
158774,3,10,0,0,13,0.23076923076923078,0.5384615384615384
266164,3,10,0,0,13,0.23076923076923078,0.5384615384615384
208406,11,38,0,1,50,0.22,0.54
156300,5,18,0,1,24,0.20833333333333334,0.5416666666666666
216027,2,8,0,1,11,0.18181818181818182,0.5454545454545454
160574,2,8,0,1,11,0.18181818181818182,0.5454545454545454
202462,5,17,0,0,22,0.22727272727272727,0.5454545454545454
233543,2,8,0,1,11,0.18181818181818182,0.5454545454545454
160200,0,6,0,5,11,0.0,0.5454545454545454
223953,2,8,0,1,11,0.18181818181818182,0.5454545454545454
245295,8,31,0,3,42,0.19047619047619047,0.5476190476190477
23571,7,24,0,0,31,0.22580645161290322,0.5483870967741935
101304,4,15,0,1,20,0.2,0.55
35836,10,37,0,2,49,0.20408163265306123,0.5510204081632653
222716,2,7,0,0,9,0.2222222222222222,0.5555555555555556
203603,2,7,0,0,9,0.2222222222222222,0.5555555555555556
185140,2,7,0,0,9,0.2222222222222222,0.5555555555555556
222563,2,7,0,0,9,0.2222222222222222,0.5555555555555556
177186,2,7,0,0,9,0.2222222222222222,0.5555555555555556
139467,2,7,0,0,9,0.2222222222222222,0.5555555555555556
132684,2,7,0,0,9,0.2222222222222222,0.5555555555555556
275154,4,14,0,0,18,0.2222222222222222,0.5555555555555556
67515,2,7,0,0,9,0.2222222222222222,0.5555555555555556
124747,2,7,0,0,9,0.2222222222222222,0.5555555555555556
123544,10,35,0,0,45,0.2222222222222222,0.5555555555555556
183101,4,14,0,0,18,0.2222222222222222,0.5555555555555556
209536,2,7,0,0,9,0.2222222222222222,0.5555555555555556
259380,2,7,0,0,9,0.2222222222222222,0.5555555555555556
28938,2,7,0,0,9,0.2222222222222222,0.5555555555555556
43359,2,7,0,0,9,0.2222222222222222,0.5555555555555556
43626,2,7,0,0,9,0.2222222222222222,0.5555555555555556
93130,2,7,0,0,9,0.2222222222222222,0.5555555555555556
218411,2,7,0,0,9,0.2222222222222222,0.5555555555555556
71234,4,14,0,0,18,0.2222222222222222,0.5555555555555556
24995,2,7,0,0,9,0.2222222222222222,0.5555555555555556
187835,2,7,0,0,9,0.2222222222222222,0.5555555555555556
135895,2,7,0,0,9,0.2222222222222222,0.5555555555555556
41111,2,7,0,0,9,0.2222222222222222,0.5555555555555556
101141,2,7,0,0,9,0.2222222222222222,0.5555555555555556
246216,2,7,0,0,9,0.2222222222222222,0.5555555555555556
247918,2,7,0,0,9,0.2222222222222222,0.5555555555555556
94965,2,7,0,0,9,0.2222222222222222,0.5555555555555556
248531,2,7,0,0,9,0.2222222222222222,0.5555555555555556
232945,14,53,0,3,70,0.2,0.5571428571428572
158226,6,49,0,22,77,0.07792207792207792,0.5584415584415584
6532,0,14,0,11,25,0.0,0.56
169682,8,30,0,1,39,0.20512820512820512,0.5641025641025641
116005,4,17,0,2,23,0.17391304347826086,0.5652173913043478
34215,0,4,0,3,7,0.0,0.5714285714285714
41596,1,5,0,1,7,0.14285714285714285,0.5714285714285714
